Player,Nation,POS,Age,90s,Tackles_Tkl,Tackles_TklW,Tackles_Def 3rd,Tackles_Mid 3rd,Tackles_Att 3rd,Challenges_Tkl,Challenges_Att,Challenges_Tkl%,Challenges_Lost,Blocks_Blocks,Blocks_Sh,Blocks_Pass,Unnamed: 17_level_0_Int,Unnamed: 18_level_0_Tkl+Int,Clr,Err,Unnamed: 21_level_0_Matches,Team
Drake Callender,USA,GK,26,22.0,2,1,2,0,0,1,1,100.0,0,0,0,0,1,3,9,2,Matches,Inter Miami
Julian Gressel,USA,MF,30,19.0,21,12,9,10,2,9,25,36.0,16,13,4,9,11,32,10,2,Matches,Inter Miami
Sergio Busquets,ESP,MF,35,20.3,49,28,18,25,6,30,58,51.7,28,33,9,24,17,66,30,3,Matches,Inter Miami
Tomás Avilés,ARG,DF,20,17.0,34,20,26,6,2,13,26,50.0,13,20,12,8,29,63,53,2,Matches,Inter Miami
Robert Taylor,FIN,FW,29,14.5,12,9,5,2,5,3,13,23.1,10,12,0,12,11,23,4,0,Matches,Inter Miami
Jordi Alba,ESP,DF,35,15.6,18,11,8,8,2,8,24,33.3,16,14,5,9,9,27,25,1,Matches,Inter Miami
Marcelo Weigandt,ARG,DF,24,14.4,39,25,27,12,0,27,47,57.4,20,20,6,14,11,50,40,0,Matches,Inter Miami
Serhiy Kryvtsov,UKR,DF,33,13.0,10,6,8,2,0,7,16,43.8,9,29,22,7,18,28,57,1,Matches,Inter Miami
Luis Suárez,URU,FW,37,12.8,2,1,1,1,0,0,1,0.0,1,2,0,2,2,4,8,0,Matches,Inter Miami
Lionel Messi,ARG,FW,37,11.5,12,5,0,5,7,4,5,80.0,1,4,0,4,2,14,0,0,Matches,Inter Miami
Leonardo Campana,ECU,FW,23,11.2,10,8,0,7,3,3,9,33.3,6,9,1,8,1,11,8,0,Matches,Inter Miami
David Ruiz,HON,MF,20,9.8,27,22,15,11,1,14,34,41.2,20,13,3,10,13,40,11,1,Matches,Inter Miami
Ben Cremaschi,USA,MF,19,9.3,15,12,6,7,2,7,17,41.2,10,11,2,9,13,28,9,0,Matches,Inter Miami
Diego Gómez,PAR,MF,21,8.9,33,19,10,18,5,16,35,45.7,19,19,1,18,11,44,5,1,Matches,Inter Miami
Nicolás Freire,ARG,DF,30,8.2,9,4,8,1,0,7,11,63.6,4,16,9,7,13,22,41,0,Matches,Inter Miami
Franco Negri,ARG,DF,29,6.8,15,11,11,2,2,11,17,64.7,6,10,2,8,13,28,19,0,Matches,Inter Miami
Federico Redondo,ARG,MF,21,5.1,11,8,5,5,1,7,9,77.8,2,6,1,5,1,12,4,0,Matches,Inter Miami
Yannick Bright,ITA,MF,22,6.3,18,12,7,9,2,8,23,34.8,15,11,5,6,20,38,19,0,Matches,Inter Miami
Noah Allen,USA,DF,20,5.7,12,8,11,1,0,6,12,50.0,6,4,1,3,4,16,12,0,Matches,Inter Miami
Matías Rojas,PAR,FW,28,5.5,11,6,5,5,1,4,8,50.0,4,6,1,5,2,13,1,0,Matches,Inter Miami
DeAndre Yedlin,USA,DF,31,3.0,6,2,3,3,0,3,7,42.9,4,4,1,3,7,13,11,0,Matches,Inter Miami
Lawson Sunderland,USA,MF,22,2.1,4,3,1,3,0,1,4,25.0,3,6,1,5,3,7,1,0,Matches,Inter Miami
Ryan Sailor,USA,DF,25,3.4,3,2,3,0,0,2,2,100.0,0,2,2,0,4,7,16,1,Matches,Inter Miami
Ian Fray,USA,DF,21,1.6,7,5,5,1,1,2,5,40.0,3,2,1,1,5,12,2,0,Matches,Inter Miami
Leonardo Afonso,BRA,FW,23,2.4,8,6,5,2,1,2,6,33.3,4,2,0,2,5,13,2,0,Matches,Inter Miami
Shanyder Borgelin,HAI,FW,22,1.5,2,2,1,1,0,0,1,0.0,1,0,0,0,0,2,3,0,Matches,Inter Miami
C.J. dos Santos,USA,GK,23,1.0,0,0,0,0,0,0,0,,0,0,0,0,0,0,0,0,Matches,Inter Miami
Jose Casas de Abadal,USA,FW,24,0.3,2,1,0,1,1,0,1,0.0,1,0,0,0,0,2,0,0,Matches,Inter Miami
Jean Mota,BRA,MF,30,0.3,0,0,0,0,0,0,0,,0,0,0,0,0,0,0,0,Matches,Inter Miami
Pavel Bucha,CZE,MF,26,22.5,34,22,10,21,3,20,44,45.5,24,32,9,23,29,63,21,1,Matches,FC Cincinnati
Luciano Acosta,ARG,MF,30,22.1,32,21,11,18,3,15,27,55.6,12,20,0,20,11,43,4,0,Matches,FC Cincinnati
Luca Orellano,ARG,DF,24,20.0,30,17,21,6,3,19,37,51.4,18,17,1,16,6,36,23,2,Matches,FC Cincinnati
Roman Celentano,USA,GK,23,19.0,0,0,0,0,0,0,3,0.0,3,0,0,0,0,0,8,0,Matches,FC Cincinnati
Obinna Nwobodo,NGA,MF,27,16.7,46,33,21,22,3,14,29,48.3,15,21,9,12,34,80,22,0,Matches,FC Cincinnati
Ian Murphy,USA,DF,24,18.2,27,18,15,12,0,12,20,60.0,8,19,9,10,22,49,58,0,Matches,FC Cincinnati
Yuya Kubo,JPN,FW,30,17.0,44,26,17,17,10,24,37,64.9,13,14,3,11,14,58,16,1,Matches,FC Cincinnati
Miles Robinson,USA,DF,27,16.8,29,22,15,13,1,15,19,78.9,4,20,7,13,22,51,71,0,Matches,FC Cincinnati
Matt Miazga,USA,DF,28,15.7,23,11,19,3,1,12,18,66.7,6,18,13,5,12,35,76,1,Matches,FC Cincinnati
DeAndre Yedlin,USA,DF,31,15.4,28,15,14,12,2,15,30,50.0,15,18,5,13,14,42,32,0,Matches,FC Cincinnati
Corey Baird,USA,FW,28,9.1,7,2,6,1,0,3,9,33.3,6,4,0,4,1,8,5,0,Matches,FC Cincinnati
Kevin Kelsy,VEN,FW,19,8.1,4,2,1,1,2,1,1,100.0,0,7,0,7,3,7,4,0,Matches,FC Cincinnati
Gerardo Valenzuela,USA,FW,20,8.6,22,15,3,13,6,9,18,50.0,9,11,2,9,4,26,8,0,Matches,FC Cincinnati
Kipp Keller,USA,DF,24,7.2,8,8,6,2,0,5,6,83.3,1,13,11,2,8,16,29,0,Matches,FC Cincinnati
Nick Hagglund,USA,DF,31,5.1,5,5,4,1,0,4,5,80.0,1,4,2,2,9,14,23,0,Matches,FC Cincinnati
Alvas Powell,JAM,DF,29,4.3,17,13,10,5,2,10,12,83.3,2,4,2,2,3,20,17,0,Matches,FC Cincinnati
Aaron Boupendza,GAB,FW,27,5.8,4,2,0,3,1,1,7,14.3,6,4,2,2,3,7,6,0,Matches,FC Cincinnati
Sergio Santos Gomes,BRA,FW,29,6.3,12,7,5,3,4,2,10,20.0,8,5,0,5,3,15,5,1,Matches,FC Cincinnati
Yamil Asad,ARG,DF,29,4.6,13,9,7,5,1,7,15,46.7,8,9,2,7,3,16,3,0,Matches,FC Cincinnati
Alec Kann,USA,GK,33,3.0,0,0,0,0,0,0,0,,0,0,0,0,0,0,2,1,Matches,FC Cincinnati
Bret Halsey,USA,DF,24,4.2,8,6,3,3,2,4,6,66.7,2,7,0,7,2,10,5,0,Matches,FC Cincinnati
Malik Pinto,USA,MF,21,1.7,10,9,6,4,0,4,7,57.1,3,3,0,3,1,11,1,0,Matches,FC Cincinnati
Evan Louro,USA,GK,28,1.0,0,0,0,0,0,0,0,,0,0,0,0,0,0,0,0,Matches,FC Cincinnati
Isaiah Foster,USA,DF,20,0.0,0,0,0,0,0,0,0,,0,0,0,0,0,0,0,0,Matches,FC Cincinnati
Stiven Jimenez,USA,MF,17,0.0,0,0,0,0,0,0,0,,0,0,0,0,0,0,0,0,Matches,FC Cincinnati
Matt Freese,USA,GK,25,23.0,1,1,1,0,0,1,3,33.3,2,1,0,1,0,1,8,3,Matches,New York City FC
Santiago Rodríguez,URU,MF,24,22.1,28,22,11,11,6,7,28,25.0,21,19,1,18,7,35,5,0,Matches,New York City FC
Thiago Martins,BRA,DF,29,21.0,13,9,8,5,0,9,14,64.3,5,29,14,15,14,27,89,1,Matches,New York City FC
Hannes Wolf,AUT,FW,25,18.4,33,19,13,14,6,18,42,42.9,24,25,0,25,3,36,4,1,Matches,New York City FC
James Sands,USA,MF,24,19.9,63,48,20,34,9,28,38,73.7,10,34,10,24,33,96,40,1,Matches,New York City FC
Kevin O'Toole,USA,DF,25,19.0,36,24,23,7,6,22,34,64.7,12,25,4,21,21,57,48,0,Matches,New York City FC
Birk Risa,NOR,DF,26,18.6,12,8,10,2,0,8,11,72.7,3,17,15,2,16,28,60,3,Matches,New York City FC
Keaton Parks,USA,MF,26,18.6,33,24,6,22,5,18,45,40.0,27,18,3,15,5,38,28,0,Matches,New York City FC
Mitja Ilenič,SVN,DF,19,12.7,16,11,9,6,1,10,17,58.8,7,10,4,6,15,31,30,0,Matches,New York City FC
Monsef Bakrar,ALG,FW,23,12.2,15,9,1,4,10,7,12,58.3,5,19,1,18,3,18,8,0,Matches,New York City FC
Tayvon Gray,JAM,DF,21,11.0,25,14,16,6,3,18,22,81.8,4,13,4,9,24,49,24,0,Matches,New York City FC
Andrés Perea,USA,MF,23,10.4,29,15,13,12,4,17,30,56.7,13,15,1,14,15,44,19,0,Matches,New York City FC
Alonso Martínez,CRC,FW,25,8.8,4,0,2,2,0,2,5,40.0,3,4,2,2,4,8,4,0,Matches,New York City FC
Agustin Ojeda,ARG,FW,20,8.2,13,11,4,7,2,6,7,85.7,1,3,0,3,4,17,3,0,Matches,New York City FC
Strahinja Tanasijević,SRB,DF,27,7.0,6,5,2,4,0,3,4,75.0,1,10,3,7,6,12,26,0,Matches,New York City FC
Julián Fernández,ARG,FW,20,5.7,9,6,3,4,2,2,6,33.3,4,13,0,13,4,13,0,1,Matches,New York City FC
Malachi Jones,SLE,FW,20,5.4,15,10,2,9,4,4,6,66.7,2,8,1,7,3,18,7,0,Matches,New York City FC
Jovan Mijatović,SRB,FW,19,2.5,0,0,0,0,0,0,1,0.0,1,1,0,1,0,0,1,0,Matches,New York City FC
Maximiliano Moralez,ARG,MF,37,2.2,1,0,0,0,1,0,0,,0,1,0,1,4,5,0,0,Matches,New York City FC
Andres Jasson,USA,MF,22,1.7,8,5,6,1,1,3,5,60.0,2,1,0,1,1,9,5,0,Matches,New York City FC
Christian McFarlane, ENG,DF,17,1.2,3,2,0,3,0,2,2,100.0,0,1,0,1,0,3,0,0,Matches,New York City FC
Justin Haak,USA,MF,22,2.3,3,2,1,2,0,2,7,28.6,5,6,1,5,4,7,4,0,Matches,New York City FC
Talles Magno,BRA,MF,22,0.1,1,1,0,1,0,1,1,100.0,0,0,0,0,0,1,0,0,Matches,New York City FC
Diego Rossi,URU,MF,26,19.0,4,0,1,1,2,1,12,8.3,11,7,0,7,5,9,3,0,Matches,Columbus Crew
Patrick Schulte,USA,GK,23,19.0,1,0,1,0,0,1,2,50.0,1,0,0,0,0,1,3,2,Matches,Columbus Crew
Darlington Nagbe,USA,MF,33,17.7,19,10,5,12,2,8,17,47.1,9,11,3,8,4,23,11,0,Matches,Columbus Crew
Rudy Camacho,FRA,DF,33,16.0,23,12,16,7,0,16,20,80.0,4,18,9,9,25,48,51,0,Matches,Columbus Crew
Steven Moreira,CPV,DF,29,16.4,16,9,9,5,2,9,20,45.0,11,14,3,11,10,26,32,1,Matches,Columbus Crew
Malte Amundsen,DEN,DF,26,16.0,31,15,23,7,1,22,32,68.8,10,18,6,12,39,70,43,0,Matches,Columbus Crew
Cucho,COL,FW,25,14.6,19,11,4,5,10,5,10,50.0,5,15,1,14,10,29,6,0,Matches,Columbus Crew
Aidan Morris,USA,MF,22,14.2,51,33,19,27,5,25,35,71.4,10,26,4,22,23,74,9,2,Matches,Columbus Crew
Sean Zawadzki,USA,MF,24,13.7,36,20,16,14,6,17,27,63.0,10,13,4,9,20,56,27,0,Matches,Columbus Crew
Mohamed Farsi,CAN,DF,24,13.5,12,8,4,4,4,7,12,58.3,5,15,1,14,6,18,20,0,Matches,Columbus Crew
Maximilian Arfsten,USA,DF,23,12.4,18,11,9,7,2,10,25,40.0,15,15,1,14,8,26,19,0,Matches,Columbus Crew
Yaw Yeboah,GHA,DF,27,10.5,11,3,6,1,4,8,20,40.0,12,6,0,6,9,20,7,0,Matches,Columbus Crew
Yevhen Cheberko,UKR,DF,26,10.2,15,10,9,5,1,9,18,50.0,9,13,8,5,16,31,31,0,Matches,Columbus Crew
Christian Ramirez,USA,FW,33,9.0,1,1,0,0,1,1,2,50.0,1,1,0,1,0,1,8,0,Matches,Columbus Crew
Alexandru Mățan,ROU,MF,24,7.5,6,5,3,3,0,2,4,50.0,2,3,0,3,1,7,0,0,Matches,Columbus Crew
Jacen Russell-Rowe,CAN,FW,21,8.0,8,4,2,3,3,4,7,57.1,3,5,0,5,1,9,0,0,Matches,Columbus Crew
Marino Hinestroza,COL,MF,22,3.9,6,6,0,4,2,1,6,16.7,5,4,1,3,1,7,0,0,Matches,Columbus Crew
William Sands,USA,DF,24,2.8,6,3,2,3,1,2,4,50.0,2,3,0,3,2,8,3,0,Matches,Columbus Crew
Evan Bush,USA,GK,38,1.4,0,0,0,0,0,0,0,,0,0,0,0,0,0,0,0,Matches,Columbus Crew
Derrick Jones,USA,MF,27,1.8,6,3,2,4,0,5,5,100.0,0,3,0,3,3,9,4,0,Matches,Columbus Crew
Philip Quinton,USA,DF,24,1.0,0,0,0,0,0,0,0,,0,1,1,0,0,0,3,0,Matches,Columbus Crew
Taha Habroune,USA,MF,18,0.9,3,2,0,2,1,2,4,50.0,2,6,1,5,1,4,2,0,Matches,Columbus Crew
Nicholas Hagen,GUA,GK,27,0.6,0,0,0,0,0,0,0,,0,0,0,0,0,0,0,0,Matches,Columbus Crew
Cole Mrowka,USA,MF,18,0.0,0,0,0,0,0,0,0,,0,0,0,0,0,0,0,0,Matches,Columbus Crew
Dante Vanzeir,BEL,FW,26,15.7,11,4,1,3,7,6,10,60.0,4,8,0,8,3,14,5,0,Matches,New York Red Bulls
Sean Nealis,USA,DF,27,18.6,26,14,18,8,0,18,29,62.1,11,20,12,8,24,50,68,1,Matches,New York Red Bulls
Dylan Nealis,USA,DF,25,18.2,47,32,25,17,5,26,43,60.5,17,30,2,28,17,64,53,0,Matches,New York Red Bulls
Frankie Amaya,USA,MF,23,17.9,34,24,9,19,6,13,34,38.2,21,19,4,15,24,58,23,0,Matches,New York Red Bulls
Noah Eile,SWE,DF,21,17.9,19,12,10,9,0,9,15,60.0,6,14,11,3,34,53,72,0,Matches,New York Red Bulls
Daniel Edelman,USA,MF,21,17.8,31,14,5,24,2,11,29,37.9,18,33,10,23,24,55,30,1,Matches,New York Red Bulls
John Tolkin,USA,DF,21,17.6,34,22,19,9,6,13,22,59.1,9,21,4,17,17,51,32,1,Matches,New York Red Bulls
Carlos Coronel,PAR,GK,27,17.0,0,0,0,0,0,0,3,0.0,3,0,0,0,0,0,15,0,Matches,New York Red Bulls
Lewis Morgan, SCO,FW,27,16.8,14,8,4,4,6,2,9,22.2,7,13,2,11,4,18,11,0,Matches,New York Red Bulls
Wikelman Carmona,VEN,MF,21,15.6,46,30,27,13,6,18,34,52.9,16,30,2,28,12,58,13,1,Matches,New York Red Bulls
Emil Forsberg,SWE,MF,32,12.7,10,7,2,4,4,4,12,33.3,8,7,1,6,4,14,4,0,Matches,New York Red Bulls
Elias Manoel,BRA,FW,22,11.6,3,1,0,2,1,2,10,20.0,8,7,0,7,3,6,3,0,Matches,New York Red Bulls
Kyle Duncan,USA,DF,26,10.8,23,19,10,9,4,17,24,70.8,7,16,2,14,14,37,25,0,Matches,New York Red Bulls
Andrés Reyes,COL,DF,24,9.4,12,5,10,2,0,7,19,36.8,12,23,7,16,12,24,36,1,Matches,New York Red Bulls
Cameron Harper,USA,MF,22,8.5,7,5,3,1,3,5,11,45.5,6,6,1,5,3,10,10,0,Matches,New York Red Bulls
Peter Stroud,USA,MF,22,6.7,17,11,7,8,2,9,16,56.3,7,10,2,8,5,22,9,0,Matches,New York Red Bulls
Dennis Gjengaar,NOR,MF,20,6.2,6,3,1,3,2,2,8,25.0,6,11,0,11,2,8,3,0,Matches,New York Red Bulls
Ryan Meara,USA,GK,33,6.0,0,0,0,0,0,0,0,,0,0,0,0,0,0,4,0,Matches,New York Red Bulls
Ronald Donkor,MLI,MF,19,3.5,6,4,2,4,0,3,9,33.3,6,2,1,1,1,7,4,0,Matches,New York Red Bulls
Cory Burke,JAM,FW,32,2.2,4,3,0,2,2,1,3,33.3,2,3,0,3,1,5,6,0,Matches,New York Red Bulls
Julian Hall,USA,FW,16,0.9,2,1,1,0,1,1,1,100.0,0,0,0,0,2,4,0,0,Matches,New York Red Bulls
Mohammed Sofo,GHA,MF,19,0.3,1,1,0,1,0,0,1,0.0,1,1,0,1,0,1,0,0,Matches,New York Red Bulls
Roald Mitchell,USA,FW,21,0.2,0,0,0,0,0,0,0,,0,1,1,0,0,0,1,0,Matches,New York Red Bulls
Aidan O'Connor,USA,DF,22,0.2,2,0,2,0,0,1,1,100.0,0,0,0,0,0,2,0,0,Matches,New York Red Bulls
Serge Ngoma,USA,MF,19,0.2,0,0,0,0,0,0,1,0.0,1,1,0,1,0,0,0,0,Matches,New York Red Bulls
Omar Valencia,PAN,MF,20,0.0,1,1,0,1,0,1,1,100.0,0,0,0,0,0,1,1,0,Matches,New York Red Bulls
Federico Bernardeschi,ITA,DF,30,20.9,20,12,9,5,6,15,24,62.5,9,12,3,9,17,37,12,0,Matches,Toronto FC
Kevin Long,IRL,DF,33,18.2,31,11,15,15,1,18,25,72.0,7,31,15,16,12,43,95,2,Matches,Toronto FC
Nicksoen Gomis,FRA,DF,22,18.4,29,17,15,12,2,17,20,85.0,3,18,7,11,18,47,38,1,Matches,Toronto FC
Deybi Flores,HON,MF,28,18.3,51,37,24,24,3,22,49,44.9,27,19,7,12,25,76,36,1,Matches,Toronto FC
Matthew Longstaff, ENG,MF,24,17.1,35,21,8,20,7,10,24,41.7,14,13,3,10,7,42,17,0,Matches,Toronto FC
Raoul Petretta,ITA,DF,27,15.0,25,16,16,8,1,16,24,66.7,8,23,7,16,18,43,31,0,Matches,Toronto FC
Prince Osei Owusu,GER,FW,27,15.2,21,8,4,10,7,8,13,61.5,5,16,1,15,4,25,19,0,Matches,Toronto FC
Alonso Coello,ESP,MF,24,13.0,39,22,20,18,1,22,36,61.1,14,18,3,15,18,57,9,1,Matches,Toronto FC
Sean Johnson,USA,GK,35,15.0,0,0,0,0,0,0,0,,0,0,0,0,0,0,13,1,Matches,Toronto FC
Sigurd Rosted,NOR,DF,29,14.5,21,9,11,9,1,13,19,68.4,6,15,6,9,20,41,34,1,Matches,Toronto FC
Jonathan Osorio,CAN,MF,32,13.1,13,11,8,3,2,5,12,41.7,7,12,2,10,6,19,10,0,Matches,Toronto FC
Derrick Etienne,HAI,MF,27,11.8,8,8,1,4,3,5,9,55.6,4,12,2,10,5,13,8,0,Matches,Toronto FC
Lorenzo Insigne,ITA,MF,33,10.9,10,8,6,2,2,5,11,45.5,6,9,0,9,6,16,0,0,Matches,Toronto FC
Jahkeele Marshall-Rutty,CAN,DF,20,11.1,15,12,9,3,3,9,12,75.0,3,11,1,10,7,22,17,0,Matches,Toronto FC
Tyrese Spicer,,DF,,9.4,20,15,9,7,4,4,11,36.4,7,23,2,21,9,29,12,1,Matches,Toronto FC
Luka Gavran,CAN,GK,24,9.0,2,2,2,0,0,1,1,100.0,0,0,0,0,0,2,7,2,Matches,Toronto FC
Shane O'Neill,USA,DF,30,7.1,14,7,8,6,0,7,10,70.0,3,4,1,3,10,24,23,0,Matches,Toronto FC
Deandre Kerr,CAN,FW,21,6.5,4,4,0,2,2,2,2,100.0,0,3,0,3,2,6,4,0,Matches,Toronto FC
Kosi Thompson,CAN,MF,21,8.5,19,12,10,7,2,12,17,70.6,5,20,5,15,6,25,19,1,Matches,Toronto FC
Kobe Franklin,CAN,DF,21,5.1,3,2,1,1,1,2,6,33.3,4,5,1,4,2,5,17,0,Matches,Toronto FC
Aimé Mabika,ZAM,DF,25,3.7,3,2,0,3,0,0,1,0.0,1,5,4,1,4,7,15,1,Matches,Toronto FC
Richie Laryea,CAN,DF,29,0.9,4,3,4,0,0,1,1,100.0,0,0,0,0,1,5,2,0,Matches,Toronto FC
Ayo Akinola,CAN,FW,24,1.0,0,0,0,0,0,0,1,0.0,1,0,0,0,1,1,0,0,Matches,Toronto FC
Cassius Mailula,RSA,MF,23,0.2,0,0,0,0,0,0,0,,0,1,0,1,1,1,0,0,Matches,Toronto FC
Charles Sharp,USA,FW,23,0.2,0,0,0,0,0,0,0,,0,0,0,0,1,1,1,0,Matches,Toronto FC
Kristijan Kahlina,CRO,GK,31,23.0,0,0,0,0,0,0,0,,0,0,0,0,1,1,16,2,Matches,Charlotte FC
Andrew Privett,USA,DF,23,23.0,24,19,19,4,1,11,18,61.1,7,32,19,13,11,35,94,3,Matches,Charlotte FC
Ashley Westwood, ENG,MF,34,22.0,14,5,6,6,2,5,12,41.7,7,13,6,7,16,30,28,1,Matches,Charlotte FC
Kerwin Vargas,COL,FW,22,20.2,19,11,6,9,4,13,17,76.5,4,18,1,17,6,25,27,0,Matches,Charlotte FC
Adilson Malanda,FRA,DF,22,21.0,23,15,16,5,2,16,23,69.6,7,22,16,6,22,45,92,1,Matches,Charlotte FC
Nathan Byrne, ENG,DF,32,20.0,20,11,12,5,3,11,15,73.3,4,11,5,6,14,34,53,1,Matches,Charlotte FC
Jere Uronen,FIN,DF,30,17.8,33,18,17,12,4,25,41,61.0,16,27,8,19,24,57,45,0,Matches,Charlotte FC
Patrick Agyemang,USA,FW,23,15.7,13,7,0,3,10,6,12,50.0,6,6,1,5,0,13,11,0,Matches,Charlotte FC
Djibril Diani,FRA,MF,26,14.5,37,23,11,19,7,21,36,58.3,15,32,5,27,13,50,11,0,Matches,Charlotte FC
Liel Abada,ISR,FW,22,11.1,9,7,2,3,4,5,13,38.5,8,5,0,5,5,14,3,0,Matches,Charlotte FC
Brecht Dejaegere,BEL,FW,33,10.0,24,12,4,14,6,10,25,40.0,15,15,1,14,10,34,7,0,Matches,Charlotte FC
Brandt Bronico,USA,MF,29,9.9,13,7,5,3,5,4,12,33.3,8,15,4,11,6,19,3,0,Matches,Charlotte FC
Iuri Tavares,CPV,FW,23,7.8,16,9,3,8,5,7,14,50.0,7,16,2,14,5,21,15,0,Matches,Charlotte FC
Júnior Urso,BRA,MF,35,6.6,15,9,2,11,2,6,16,37.5,10,5,1,4,10,25,14,0,Matches,Charlotte FC
Enzo Copetti,ARG,FW,28,5.5,1,0,0,1,0,0,3,0.0,3,2,1,1,2,3,3,0,Matches,Charlotte FC
Nikola Petković,SRB,MF,21,5.3,9,5,2,4,3,4,8,50.0,4,6,1,5,4,13,1,0,Matches,Charlotte FC
João Pedro,BRA,DF,21,4.9,9,7,5,2,2,4,12,33.3,8,3,0,3,5,14,13,0,Matches,Charlotte FC
Scott Arfield,CAN,MF,35,4.2,2,1,1,1,0,1,3,33.3,2,5,0,5,1,3,2,0,Matches,Charlotte FC
Jaylin Lindsey,USA,DF,24,3.3,13,6,9,4,0,6,9,66.7,3,3,1,2,2,15,6,0,Matches,Charlotte FC
Ben Bender,USA,MF,23,2.1,2,0,2,0,0,0,1,0.0,1,2,0,2,0,2,1,0,Matches,Charlotte FC
Bill Tuiloma,NZL,DF,29,2.0,1,1,0,1,0,1,1,100.0,0,2,1,1,1,2,8,0,Matches,Charlotte FC
Tyger Smalls,,FW,,2.2,7,5,3,2,2,1,7,14.3,6,7,1,6,2,9,3,0,Matches,Charlotte FC
Nimfasha Berchimas,USA,FW,16,0.3,1,0,1,0,0,1,1,100.0,0,2,0,2,0,1,0,0,Matches,Charlotte FC
Nick Scardina,USA,FW,23,0.0,0,0,0,0,0,0,0,,0,0,0,0,0,0,0,0,Matches,Charlotte FC
Kai Wagner,GER,DF,27,21.5,37,22,27,8,2,19,32,59.4,13,18,8,10,24,61,43,0,Matches,Philadelphia Union
Jakob Glesnes,NOR,DF,30,20.4,38,16,29,8,1,22,41,53.7,19,25,14,11,33,71,79,1,Matches,Philadelphia Union
Nathan Harriel,USA,DF,23,19.9,49,26,16,24,9,20,33,60.6,13,38,10,28,21,70,64,1,Matches,Philadelphia Union
Jack McGlynn,USA,MF,21,19.2,40,27,17,17,6,19,34,55.9,15,19,2,17,11,51,16,0,Matches,Philadelphia Union
Quinn Sullivan,USA,MF,20,18.8,24,12,6,11,7,8,24,33.3,16,19,1,18,5,29,13,0,Matches,Philadelphia Union
Jack Elliott, ENG,DF,28,17.2,31,18,22,9,0,16,22,72.7,6,28,18,10,22,53,73,1,Matches,Philadelphia Union
Dániel Gazdag,HUN,MF,28,17.8,16,8,5,8,3,3,14,21.4,11,8,1,7,6,22,5,0,Matches,Philadelphia Union
Mikael Uhre,DEN,FW,29,13.9,21,12,3,9,9,10,19,52.6,9,8,1,7,2,23,11,0,Matches,Philadelphia Union
Oliver Semmle,GER,GK,26,15.6,1,0,1,0,0,1,1,100.0,0,0,0,0,0,1,7,0,Matches,Philadelphia Union
Leon Flach,USA,MF,23,11.8,30,15,15,12,3,16,28,57.1,12,24,2,22,25,55,13,0,Matches,Philadelphia Union
Julián Carranza,ARG,FW,24,11.9,16,14,5,4,7,5,10,50.0,5,11,1,10,10,26,19,0,Matches,Philadelphia Union
Damion Lowe,JAM,DF,31,10.0,16,15,5,8,3,11,17,64.7,6,22,9,13,17,33,45,0,Matches,Philadelphia Union
José Andrés Martínez,VEN,MF,29,9.3,20,11,8,9,3,10,18,55.6,8,8,4,4,11,31,7,1,Matches,Philadelphia Union
Alejandro Bedoya,USA,MF,37,10.9,22,13,8,10,4,9,15,60.0,6,11,0,11,13,35,11,0,Matches,Philadelphia Union
Olivier Mbaizo,CMR,DF,26,6.6,10,9,4,3,3,6,11,54.5,5,6,2,4,7,17,15,0,Matches,Philadelphia Union
Jesús Daniel Bueno,VEN,MF,25,6.4,17,13,7,8,2,9,21,42.9,12,7,0,7,9,26,1,0,Matches,Philadelphia Union
Thai Baribo,ISR,FW,26,5.1,10,7,1,6,3,3,9,33.3,6,4,0,4,3,13,1,0,Matches,Philadelphia Union
Andre Blake,JAM,GK,33,3.4,0,0,0,0,0,0,0,,0,0,0,0,0,0,1,1,Matches,Philadelphia Union
Christopher Donovan,USA,FW,23,4.2,8,5,2,3,3,4,6,66.7,2,6,0,6,2,10,1,0,Matches,Philadelphia Union
Andrew Rick,USA,GK,18,4.0,0,0,0,0,0,0,0,,0,0,0,0,0,0,3,0,Matches,Philadelphia Union
Jeremy Rafanello,USA,MF,24,3.3,3,2,0,2,1,1,6,16.7,5,3,0,3,0,3,4,0,Matches,Philadelphia Union
Markus Anderson,USA,MF,20,1.1,0,0,0,0,0,0,2,0.0,2,2,0,2,1,1,2,0,Matches,Philadelphia Union
Christopher Olney,USA,MF,17,0.2,0,0,0,0,0,0,1,0.0,1,0,0,0,1,1,0,0,Matches,Philadelphia Union
Lucas Bartlett,USA,DF,26,22.1,25,16,12,13,0,12,20,60.0,8,31,16,15,23,48,78,1,Matches,DC United
Mateusz Klich,POL,MF,34,21.4,36,22,14,12,10,19,45,42.2,26,19,4,15,13,49,2,0,Matches,DC United
Jared Stroud,USA,MF,28,19.2,34,20,17,13,4,21,47,44.7,26,19,1,18,10,44,10,0,Matches,DC United
Aaron Herrera,GUA,DF,27,20.3,44,23,18,16,10,24,39,61.5,15,38,13,25,23,67,47,0,Matches,DC United
Christian Benteke,BEL,FW,33,19.2,3,3,0,2,1,1,6,16.7,5,8,3,5,0,3,21,0,Matches,DC United
Alex Bono,USA,GK,30,19.0,2,0,2,0,0,2,2,100.0,0,0,0,0,0,2,11,1,Matches,DC United
Matti Peltola,FIN,MF,22,18.5,56,39,21,26,9,29,49,59.2,20,25,8,17,26,82,22,3,Matches,DC United
Cristián Dajome,COL,FW,30,16.7,29,19,11,15,3,16,33,48.5,17,23,4,19,12,41,18,0,Matches,DC United
Christopher McVey,SWE,DF,27,16.6,25,15,12,11,2,13,24,54.2,11,27,17,10,28,53,50,0,Matches,DC United
Theodore Ku-Dipietro,USA,MF,22,14.8,20,14,5,11,4,3,15,20.0,12,12,1,11,10,30,2,0,Matches,DC United
Pedro Santos,POR,DF,36,12.8,47,30,24,16,7,26,43,60.5,17,18,2,16,19,66,37,0,Matches,DC United
Jackson Hopkins,USA,MF,20,10.4,19,13,6,12,1,10,24,41.7,14,10,0,10,2,21,19,0,Matches,DC United
Gabriel Pirani,BRA,MF,22,9.7,17,10,5,8,4,6,12,50.0,6,7,0,7,3,20,2,0,Matches,DC United
Jacob Murrell,USA,FW,20,8.5,3,3,2,0,1,2,12,16.7,10,6,1,5,2,5,14,0,Matches,DC United
Martín Rodríguez,CHI,MF,29,7.1,16,12,4,10,2,8,15,53.3,7,10,1,9,11,27,6,0,Matches,DC United
Tyler Miller,USA,GK,31,5.0,0,0,0,0,0,0,0,,0,1,0,1,0,0,5,1,Matches,DC United
Garrison Tubbs,USA,DF,22,4.6,14,6,7,6,1,9,9,100.0,0,6,3,3,4,18,12,0,Matches,DC United
Conner Antley,USA,DF,29,4.8,16,10,10,5,1,8,13,61.5,5,8,3,5,6,22,17,0,Matches,DC United
Steve Birnbaum,USA,DF,33,3.8,2,1,1,1,0,0,3,0.0,3,4,4,0,4,6,13,0,Matches,DC United
Matai Akinmboni,USA,DF,17,4.0,8,7,5,3,0,4,5,80.0,1,7,4,3,8,16,13,0,Matches,DC United
Kristian Fletcher,USA,FW,18,2.7,3,2,2,1,0,3,8,37.5,5,4,0,4,2,5,3,0,Matches,DC United
Hayden Sargis,USA,DF,22,0.3,0,0,0,0,0,0,0,,0,1,1,0,1,1,2,0,Matches,DC United
Jeremy Garay,SLV,FW,21,0.1,1,1,1,0,0,0,0,,0,0,0,0,1,2,0,0,Matches,DC United
Mohanad Jeahze,IRQ,MF,27,0.0,0,0,0,0,0,0,0,,0,0,0,0,0,0,0,0,Matches,DC United
Iván Angulo,COL,MF,25,21.0,31,18,10,15,6,7,22,31.8,15,18,1,17,14,45,9,0,Matches,Orlando City
Dagur Dan Þórhallsson,ISL,DF,24,19.0,37,25,21,7,9,18,34,52.9,16,12,6,6,12,49,36,0,Matches,Orlando City
Facundo Torres,URU,MF,24,19.5,22,11,9,4,9,14,27,51.9,13,14,1,13,7,29,8,0,Matches,Orlando City
Robin Jansson,SWE,DF,32,18.6,18,10,13,4,1,9,18,50.0,9,26,17,9,17,35,58,0,Matches,Orlando City
Pedro Gallese,PER,GK,34,18.0,0,0,0,0,0,0,1,0.0,1,0,0,0,0,0,5,3,Matches,Orlando City
César Araujo,URU,MF,23,17.2,46,28,19,19,8,28,63,44.4,35,23,6,17,16,62,13,0,Matches,Orlando City
Duncan McGuire,USA,FW,23,14.9,7,4,1,5,1,2,16,12.5,14,8,1,7,4,11,15,0,Matches,Orlando City
Rodrigo Schlegel,ARG,DF,27,16.1,28,18,17,8,3,18,26,69.2,8,24,7,17,22,50,57,1,Matches,Orlando City
Nicolás Lodeiro,URU,MF,35,16.1,31,18,13,14,4,18,45,40.0,27,23,2,21,13,44,9,0,Matches,Orlando City
Wilder Cartagena,PER,MF,29,14.6,36,23,15,16,5,21,35,60.0,14,19,6,13,10,46,34,0,Matches,Orlando City
Martín Ojeda,ARG,MF,25,13.8,15,9,6,3,6,3,11,27.3,8,14,0,14,5,20,5,0,Matches,Orlando City
Luis Muriel,COL,FW,33,14.3,20,15,5,3,12,11,21,52.4,10,6,0,6,2,22,5,0,Matches,Orlando City
Rafael Santos,BRA,DF,26,13.0,14,5,5,6,3,7,23,30.4,16,9,0,9,14,28,20,1,Matches,Orlando City
David Brekalo,SVN,DF,25,11.0,14,1,8,6,0,9,13,69.2,4,9,2,7,16,30,38,0,Matches,Orlando City
Kyle Smith,USA,DF,32,8.4,15,5,8,6,1,8,16,50.0,8,13,3,10,5,20,28,0,Matches,Orlando City
Mason Stajduhar,USA,GK,26,4.3,0,0,0,0,0,0,1,0.0,1,0,0,0,0,0,1,0,Matches,Orlando City
Felipe,BRA,MF,33,2.9,8,7,5,3,0,6,11,54.5,5,1,0,1,5,13,5,1,Matches,Orlando City
Ramiro Enrique,ARG,FW,23,3.6,0,0,0,0,0,0,4,0.0,4,4,0,4,0,0,5,0,Matches,Orlando City
Jack Lynn,USA,FW,24,2.8,2,2,1,0,1,1,5,20.0,4,2,1,1,0,2,2,0,Matches,Orlando City
Jeorgio Kocevski,USA,MF,21,1.1,2,2,2,0,0,2,4,50.0,2,0,0,0,1,3,4,0,Matches,Orlando City
Michael Halliday,USA,DF,21,1.0,5,3,3,1,1,2,4,50.0,2,3,0,3,1,6,1,0,Matches,Orlando City
Javier Otero,VEN,GK,21,0.7,0,0,0,0,0,0,0,,0,0,0,0,0,0,0,0,Matches,Orlando City
Alexander Freeman,USA,DF,19,0.1,0,0,0,0,0,0,0,,0,0,0,0,0,0,0,0,Matches,Orlando City
Shakur Mohammed,GHA,MF,20,0.1,0,0,0,0,0,0,0,,0,0,0,0,0,0,0,0,Matches,Orlando City
Yutaro Tsukada,JPN,FW,22,0.0,0,0,0,0,0,0,0,,0,0,0,0,0,0,0,0,Matches,Orlando City
Jack Maher,USA,DF,24,21.0,27,17,22,5,0,20,27,74.1,7,30,19,11,26,53,75,0,Matches,Nashville SC
Hany Mukhtar,GER,MF,29,19.8,16,7,4,10,2,5,15,33.3,10,18,0,18,2,18,1,1,Matches,Nashville SC
Dru Yearwood, ENG,MF,24,16.6,40,27,23,12,5,18,47,38.3,29,30,2,28,20,60,18,0,Matches,Nashville SC
Joe Willis,USA,GK,35,19.2,1,1,1,0,0,1,1,100.0,0,0,0,0,1,2,6,0,Matches,Nashville SC
Sam Surridge, ENG,FW,25,17.5,12,7,6,4,2,4,7,57.1,3,10,1,9,2,14,19,0,Matches,Nashville SC
Alex Muyl,USA,FW,28,16.4,29,21,12,11,6,9,25,36.0,16,19,2,17,13,42,14,0,Matches,Nashville SC
Daniel Lovitz,USA,DF,32,16.0,27,22,20,6,1,20,35,57.1,15,11,4,7,16,43,35,1,Matches,Nashville SC
Sean Davis,USA,MF,31,12.6,15,10,10,4,1,4,11,36.4,7,18,6,12,18,33,19,0,Matches,Nashville SC
Josh Bauer,USA,DF,25,14.6,32,23,25,5,2,16,25,64.0,9,20,14,6,17,49,46,0,Matches,Nashville SC
Walker Zimmerman,USA,DF,31,12.4,17,8,10,5,2,9,16,56.3,7,14,10,4,29,46,55,0,Matches,Nashville SC
Tyler Boyd,USA,FW,29,12.3,14,12,5,6,3,10,23,43.5,13,11,1,10,5,19,6,0,Matches,Nashville SC
Aníbal Godoy,PAN,MF,34,10.6,24,15,9,15,0,12,21,57.1,9,10,3,7,25,49,4,1,Matches,Nashville SC
Shaquell Moore,USA,DF,27,10.0,21,16,13,8,0,14,24,58.3,10,6,3,3,3,24,28,0,Matches,Nashville SC
Jacob Shaffelburg,CAN,DF,24,10.0,10,6,2,7,1,3,12,25.0,9,19,1,18,6,16,8,0,Matches,Nashville SC
Brian Anunga,CMR,MF,27,9.0,30,15,14,13,3,12,20,60.0,8,14,4,10,14,44,8,0,Matches,Nashville SC
Teal Bunbury,USA,FW,34,8.7,5,0,3,2,0,2,7,28.6,5,3,1,2,1,6,5,0,Matches,Nashville SC
Taylor Washington,USA,DF,30,5.4,7,6,3,2,2,6,10,60.0,4,5,2,3,4,11,16,0,Matches,Nashville SC
Lukas MacNaughton,CAN,DF,29,4.6,6,4,6,0,0,2,5,40.0,3,5,4,1,4,10,24,0,Matches,Nashville SC
Brent Kallman,USA,DF,33,5.0,5,2,3,2,0,3,5,60.0,2,10,6,4,9,14,28,0,Matches,Nashville SC
Elliot Panicco,USA,GK,27,3.8,0,0,0,0,0,0,0,,0,0,0,0,0,0,0,1,Matches,Nashville SC
Forster Ajago,GHA,FW,22,2.2,5,3,1,4,0,2,3,66.7,1,3,0,3,3,8,2,0,Matches,Nashville SC
Amar Sejdic,USA,MF,27,2.9,7,4,3,4,0,4,8,50.0,4,2,1,1,5,12,3,1,Matches,Nashville SC
McKinze Gaines,USA,MF,26,1.4,1,1,0,1,0,0,2,0.0,2,0,0,0,0,1,0,0,Matches,Nashville SC
Isaiah Jones,USA,MF,18,0.1,1,0,0,1,0,0,0,,0,0,0,0,0,1,0,0,Matches,Nashville SC
Randall Leal,CRC,MF,27,0.1,0,0,0,0,0,0,0,,0,0,0,0,0,0,0,0,Matches,Nashville SC
Joseph Skinner,USA,FW,21,0.0,1,0,0,1,0,0,1,0.0,1,1,0,1,0,1,0,0,Matches,Nashville SC
Brooks Lennon,USA,DF,26,23.0,40,25,19,16,5,24,37,64.9,13,21,9,12,24,64,61,0,Matches,Atlanta United
Caleb Wiley,USA,DF,19,20.9,32,24,23,7,2,21,37,56.8,16,30,9,21,25,57,60,0,Matches,Atlanta United
Brad Guzan,USA,GK,39,20.7,0,0,0,0,0,0,0,,0,0,0,0,1,1,11,1,Matches,Atlanta United
Tristan Muyumba,,MF,27,19.4,61,43,28,28,5,31,51,60.8,20,19,5,14,17,78,17,0,Matches,Atlanta United
Saba Lobzhanidze,GEO,FW,29,16.6,16,13,5,7,4,7,16,43.8,9,18,4,14,4,20,3,0,Matches,Atlanta United
Bartosz Slisz,POL,MF,25,15.9,32,16,14,17,1,12,29,41.4,17,20,10,10,26,58,19,1,Matches,Atlanta United
Thiago Almada,ARG,MF,23,15.5,18,9,9,5,4,7,20,35.0,13,5,0,5,1,19,5,1,Matches,Atlanta United
Noah Cobb,USA,DF,18,14.5,19,14,12,7,0,15,22,68.2,7,22,15,7,9,28,59,0,Matches,Atlanta United
Derrick Williams,IRL,DF,31,14.5,19,11,8,11,0,8,15,53.3,7,22,17,5,17,36,65,2,Matches,Atlanta United
Xande Silva,POR,FW,27,12.2,20,16,5,7,8,10,21,47.6,11,14,1,13,5,25,7,0,Matches,Atlanta United
Daniel Armando Ríos,MEX,FW,29,9.9,8,6,2,5,1,3,8,37.5,5,7,2,5,0,8,10,0,Matches,Atlanta United
Luis Abram,PER,DF,28,10.5,8,5,4,1,3,3,8,37.5,5,8,6,2,7,15,44,1,Matches,Atlanta United
Stian Rode Gregersen,NOR,DF,29,9.7,23,18,22,1,0,11,16,68.8,5,22,14,8,10,33,45,0,Matches,Atlanta United
Giorgos Giakoumakis,GRE,FW,29,8.0,9,7,0,7,2,6,8,75.0,2,6,1,5,3,12,10,0,Matches,Atlanta United
Dax McCarty,USA,MF,37,7.1,23,12,11,10,2,15,22,68.2,7,4,0,4,11,34,7,0,Matches,Atlanta United
Jamal Thiaré,SEN,FW,31,7.0,3,3,0,3,0,1,5,20.0,4,3,1,2,0,3,8,0,Matches,Atlanta United
Ajani Fortune,TRI,MF,21,5.8,10,6,3,5,2,5,10,50.0,5,3,2,1,10,20,7,0,Matches,Atlanta United
Edwin Mosquera,COL,FW,23,4.5,8,6,3,4,1,2,7,28.6,5,2,0,2,4,12,1,1,Matches,Atlanta United
Ronald Hernández,VEN,DF,26,4.5,6,3,4,2,0,4,7,57.1,3,2,1,1,6,12,9,0,Matches,Atlanta United
Tyler Wolff,USA,FW,21,3.8,10,8,4,4,2,6,14,42.9,8,10,0,10,4,14,2,0,Matches,Atlanta United
Efrain Morales,BOL,DF,20,2.7,3,1,2,1,0,2,3,66.7,1,2,2,0,3,6,15,0,Matches,Atlanta United
Josh Cohen,USA,GK,31,2.3,0,0,0,0,0,0,0,,0,0,0,0,0,0,0,0,Matches,Atlanta United
Nicolas Firmino,USA,FW,23,1.8,1,1,0,1,0,1,1,100.0,0,2,0,2,1,2,0,0,Matches,Atlanta United
Luke Brennan,USA,FW,19,1.0,0,0,0,0,0,0,1,0.0,1,2,0,2,0,0,0,0,Matches,Atlanta United
Derrick Etienne,HAI,FW,27,0.3,1,1,1,0,0,1,1,100.0,0,0,0,0,2,3,0,0,Matches,Atlanta United
Matthew Edwards,USA,DF,21,0.0,0,0,0,0,0,0,0,,0,0,0,0,0,0,0,0,Matches,Atlanta United
Jonathan Sirois,CAN,GK,23,22.0,2,1,2,0,0,2,2,100.0,0,0,0,0,0,2,20,3,Matches,CF Montréal
Ruan,BRA,DF,29,20.5,18,14,10,5,3,4,16,25.0,12,17,3,14,10,28,32,1,Matches,CF Montréal
Ariel Lassiter,CRC,DF,29,16.0,9,5,7,2,0,4,12,33.3,8,7,1,6,3,12,15,0,Matches,CF Montréal
Bryce Duke,USA,MF,23,16.2,25,18,8,15,2,10,24,41.7,14,20,1,19,13,38,12,1,Matches,CF Montréal
Joel Waterman,CAN,DF,28,15.6,16,10,11,3,2,10,13,76.9,3,27,21,6,30,46,69,0,Matches,CF Montréal
George Campbell,USA,DF,23,15.5,20,17,12,6,2,12,19,63.2,7,28,15,13,23,43,61,3,Matches,CF Montréal
Fernando Álvarez,COL,DF,20,14.7,20,13,13,7,0,14,17,82.4,3,20,11,9,24,44,52,0,Matches,CF Montréal
Mathieu Choiniere,CAN,MF,25,14.6,29,19,12,13,4,13,26,50.0,13,18,4,14,7,36,18,1,Matches,CF Montréal
Samuel Piette,CAN,MF,29,14.1,31,22,11,15,5,20,36,55.6,16,20,6,14,16,47,16,0,Matches,CF Montréal
Gabriele Corbo,ITA,DF,24,14.0,13,8,6,6,1,8,14,57.1,6,21,16,5,10,23,66,0,Matches,CF Montréal
Joaquin Sosa,URU,DF,22,12.3,33,21,17,13,3,23,32,71.9,9,18,5,13,18,51,39,0,Matches,CF Montréal
Raheem Edwards,CAN,DF,28,10.0,27,20,17,4,6,10,19,52.6,9,16,1,15,13,40,15,0,Matches,CF Montréal
Sunusi Ibrahim,NGA,FW,21,9.9,4,2,0,3,1,1,5,20.0,4,5,2,3,4,8,18,0,Matches,CF Montréal
Nathan-Dylan Saliba,CAN,MF,19,9.3,22,12,9,11,2,11,21,52.4,10,13,6,7,5,27,20,0,Matches,CF Montréal
Jules-Anthony Vilsaint,CAN,MF,21,6.9,4,0,0,4,0,2,4,50.0,2,5,1,4,1,5,5,0,Matches,CF Montréal
Matías Cóccaro,URU,FW,26,6.4,3,1,1,2,0,2,3,66.7,1,15,3,12,3,6,6,0,Matches,CF Montréal
Josef Martínez,VEN,FW,31,8.4,2,1,2,0,0,1,3,33.3,2,3,1,2,1,3,8,0,Matches,CF Montréal
Dominik Yankov,BUL,MF,23,7.3,11,4,4,4,3,5,15,33.3,10,10,0,10,2,13,2,0,Matches,CF Montréal
Mason Toye,USA,FW,25,4.7,0,0,0,0,0,0,3,0.0,3,3,0,3,2,2,5,0,Matches,CF Montréal
Kwadwo Opoku,GHA,MF,23,3.2,0,0,0,0,0,0,4,0.0,4,0,0,0,1,1,2,0,Matches,CF Montréal
Victor Wanyama,KEN,MF,33,4.5,8,6,1,6,1,5,12,41.7,7,4,2,2,5,13,10,0,Matches,CF Montréal
Lassi Lappalainen,FIN,DF,25,2.8,11,5,9,2,0,8,11,72.7,3,9,2,7,3,14,7,0,Matches,CF Montréal
Rida Zouhir,CAN,MF,20,2.0,5,3,1,2,2,2,3,66.7,1,2,0,2,2,7,0,0,Matches,CF Montréal
Sebastian Breza,CAN,GK,26,1.0,0,0,0,0,0,0,0,,0,0,0,0,0,0,1,0,Matches,CF Montréal
Alessandro Biello,CAN,MF,18,0.2,1,1,0,1,0,1,1,100.0,0,0,0,0,1,2,0,0,Matches,CF Montréal
Ousman jabang,USA,DF,23,0.0,2,2,2,0,0,1,1,100.0,0,1,0,1,0,2,0,0,Matches,CF Montréal
Hugo Cuypers,BEL,FW,27,21.4,27,20,3,15,9,8,36,22.2,28,30,2,28,7,34,22,0,Matches,Chicago Fire
Christopher Brady,USA,GK,20,22.0,0,0,0,0,0,0,1,0.0,1,0,0,0,0,0,14,3,Matches,Chicago Fire
Allan Arigoni,SUI,DF,25,19.4,35,25,18,11,6,21,33,63.6,12,28,5,23,16,51,41,0,Matches,Chicago Fire
Rafael Czichos,GER,DF,34,19.6,43,29,30,11,2,28,39,71.8,11,33,14,19,17,60,67,3,Matches,Chicago Fire
Kellyn Acosta,USA,MF,28,18.3,29,21,11,16,2,13,34,38.2,21,15,1,14,26,55,8,1,Matches,Chicago Fire
Brian Gutiérrez,USA,MF,21,18.3,36,12,9,23,4,16,33,48.5,17,13,0,13,15,51,7,0,Matches,Chicago Fire
Fabian Herbers,GER,MF,30,17.9,47,29,12,28,7,14,38,36.8,24,23,5,18,25,72,13,1,Matches,Chicago Fire
Maren Haile-Selassie,SUI,FW,25,14.9,6,5,3,2,1,3,17,17.6,14,12,1,11,7,13,6,0,Matches,Chicago Fire
Carlos Terán,COL,DF,23,11.1,26,19,15,10,1,14,16,87.5,2,16,9,7,22,48,35,1,Matches,Chicago Fire
Arnaud Souquet,FRA,DF,32,11.4,20,15,14,6,0,9,18,50.0,9,17,3,14,15,35,29,0,Matches,Chicago Fire
Mauricio Pineda,USA,DF,26,11.3,12,7,9,3,0,8,16,50.0,8,15,5,10,7,19,27,1,Matches,Chicago Fire
Chris Mueller,USA,FW,27,9.7,14,9,8,4,2,9,19,47.4,10,9,0,9,8,22,7,0,Matches,Chicago Fire
Xherdan Shaqiri,SUI,MF,32,8.2,3,1,1,2,0,2,6,33.3,4,2,0,2,1,4,1,0,Matches,Chicago Fire
Gastón Giménez,PAR,MF,32,8.9,25,19,12,11,2,8,17,47.1,9,14,4,10,22,47,17,0,Matches,Chicago Fire
Jonathan Dean,USA,DF,27,8.5,16,10,7,8,1,6,13,46.2,7,11,4,7,9,25,27,0,Matches,Chicago Fire
Andrew Gutman,USA,DF,27,5.7,13,8,6,6,1,5,9,55.6,4,5,2,3,7,20,11,1,Matches,Chicago Fire
Tobias Salquist,DEN,DF,29,5.0,3,2,2,1,0,3,4,75.0,1,5,5,0,5,8,32,0,Matches,Chicago Fire
Federico Navarro,ARG,MF,24,4.8,20,13,11,7,2,8,11,72.7,3,4,3,1,11,31,12,1,Matches,Chicago Fire
Wyatt Omsberg,USA,DF,28,2.8,2,1,1,1,0,1,1,100.0,0,4,3,1,6,8,14,0,Matches,Chicago Fire
Georgios Koutsias,GRE,FW,20,5.0,10,7,2,5,3,3,9,33.3,6,1,0,1,1,11,2,0,Matches,Chicago Fire
Tom Barlow,USA,FW,29,4.6,4,3,0,3,1,3,8,37.5,5,4,1,3,3,7,5,0,Matches,Chicago Fire
Chase Gasper,USA,DF,28,2.7,2,1,2,0,0,2,2,100.0,0,3,0,3,7,9,14,0,Matches,Chicago Fire
Spencer Richey,USA,GK,32,1.0,0,0,0,0,0,0,0,,0,0,0,0,0,0,1,1,Matches,Chicago Fire
Omari Glasgow,GUY,MF,20,0.4,1,1,0,1,0,1,1,100.0,0,2,1,1,0,1,0,0,Matches,Chicago Fire
Javier Casas,USA,MF,21,0.0,0,0,0,0,0,0,0,,0,0,0,0,0,0,0,0,Matches,Chicago Fire
Matt Polster,USA,MF,31,18.3,30,17,15,14,1,14,26,53.8,12,15,8,7,25,55,19,0,Matches,New England Revolution
Giacomo Vrioni,ALB,FW,25,17.6,10,7,3,3,4,3,8,37.5,5,6,0,6,1,11,2,0,Matches,New England Revolution
Carles Gil,ESP,MF,31,17.0,8,5,2,5,1,2,12,16.7,10,8,0,8,4,12,3,0,Matches,New England Revolution
Nick Lima,USA,DF,29,16.0,22,16,15,6,1,17,31,54.8,14,15,5,10,15,37,40,0,Matches,New England Revolution
DeJuan Jones,USA,DF,27,15.7,31,25,21,8,2,15,28,53.6,13,24,6,18,22,53,41,0,Matches,New England Revolution
Esmir Bajraktarevic,USA,FW,19,14.4,25,15,8,13,4,5,21,23.8,16,13,0,13,3,28,7,0,Matches,New England Revolution
Henry Kessler,USA,DF,26,14.0,17,12,13,4,0,7,12,58.3,5,25,18,7,11,28,53,0,Matches,New England Revolution
David Romney,USA,DF,31,13.6,17,5,10,7,0,9,14,64.3,5,27,14,13,8,25,93,0,Matches,New England Revolution
Aljaž Ivačič,SVN,GK,30,12.0,0,0,0,0,0,0,0,,0,0,0,0,0,0,6,0,Matches,New England Revolution
Xavier Arreaga,ECU,DF,29,11.8,30,18,22,8,0,20,24,83.3,4,15,4,11,19,49,62,0,Matches,New England Revolution
Ian Harkes,USA,MF,29,11.7,23,16,8,12,3,12,17,70.6,5,11,3,8,13,36,13,0,Matches,New England Revolution
Tomás Chancalay,ARG,FW,25,10.3,10,4,3,5,2,4,20,20.0,16,10,0,10,1,11,2,1,Matches,New England Revolution
Mark-Anthony Kaye,CAN,MF,29,9.7,34,22,16,16,2,17,32,53.1,15,23,4,19,9,43,11,1,Matches,New England Revolution
Henrich Ravas,SVK,GK,26,8.0,0,0,0,0,0,0,1,0.0,1,1,0,1,0,0,1,2,Matches,New England Revolution
Noel Buck, ENG,MF,19,6.0,11,4,5,5,1,4,5,80.0,1,7,3,4,3,14,4,0,Matches,New England Revolution
Dylan Borrero,COL,FW,22,5.6,3,3,1,0,2,1,4,25.0,3,4,0,4,8,11,4,0,Matches,New England Revolution
Nacho Gil,ESP,FW,28,5.2,9,5,5,2,2,2,7,28.6,5,5,1,4,6,15,3,0,Matches,New England Revolution
Andrew Farrell,USA,DF,32,5.1,8,7,6,2,0,5,7,71.4,2,6,5,1,3,11,11,0,Matches,New England Revolution
Emmanuel Boateng,GHA,FW,30,4.2,7,3,2,3,2,1,2,50.0,1,8,1,7,4,11,1,0,Matches,New England Revolution
Ryan Spaulding,USA,DF,25,4.2,13,6,6,4,3,6,7,85.7,1,8,2,6,7,20,12,0,Matches,New England Revolution
Brandon Bye,USA,DF,28,2.2,2,1,0,1,1,0,3,0.0,3,3,1,2,2,4,8,0,Matches,New England Revolution
Jack Panayotou,USA,FW,20,1.9,3,1,1,2,0,3,5,60.0,2,3,0,3,0,3,2,0,Matches,New England Revolution
Jonathan Mensah,GHA,DF,34,1.9,2,2,2,0,0,2,2,100.0,0,7,7,0,0,2,10,0,Matches,New England Revolution
Earl Edwards Jr.,USA,GK,32,1.0,0,0,0,0,0,0,0,,0,0,0,0,0,0,1,1,Matches,New England Revolution
Thomas McNamara,USA,MF,33,1.0,1,1,0,1,0,1,1,100.0,0,0,0,0,0,1,0,0,Matches,New England Revolution
Bobby Wood,USA,FW,31,0.8,1,0,0,1,0,0,0,,0,1,0,1,0,1,0,0,Matches,New England Revolution
Marcos Dias,BRA,FW,22,0.0,0,0,0,0,0,0,0,,0,0,0,0,0,0,0,0,Matches,New England Revolution
Malcolm Fry,USA,FW,19,0.0,0,0,0,0,0,0,0,,0,0,0,0,0,0,0,0,Matches,New England Revolution
Emeka Eneli,USA,MF,24,20.5,41,26,14,23,4,18,41,43.9,23,30,4,26,34,75,15,0,Matches,Real Salt Lake
Cristian Arango,COL,FW,29,20.6,16,10,4,8,4,5,16,31.3,11,16,1,15,3,19,3,0,Matches,Real Salt Lake
Braian Ojeda,PAR,MF,24,20.6,33,24,11,17,5,14,29,48.3,15,15,2,13,23,56,27,2,Matches,Real Salt Lake
Carlos Gómez,COL,FW,21,19.1,36,24,12,16,8,12,38,31.6,26,24,4,20,7,43,11,0,Matches,Real Salt Lake
Andrew Brody,USA,DF,29,19.3,15,11,11,4,0,7,19,36.8,12,17,9,8,20,35,45,1,Matches,Real Salt Lake
Diego Luna,USA,FW,20,16.6,28,18,5,17,6,9,17,52.9,8,16,2,14,8,36,7,0,Matches,Real Salt Lake
Zac MacMath,USA,GK,32,17.0,0,0,0,0,0,0,0,,0,0,0,0,1,1,7,5,Matches,Real Salt Lake
Brayan Vera,COL,DF,25,16.4,21,10,12,9,0,7,11,63.6,4,27,18,9,10,31,53,0,Matches,Real Salt Lake
Alexandros Katranis,GRE,DF,26,15.2,30,18,15,13,2,12,29,41.4,17,26,7,19,18,48,23,0,Matches,Real Salt Lake
Justen Glad,USA,DF,27,15.0,12,7,7,5,0,6,14,42.9,8,29,20,9,22,34,42,1,Matches,Real Salt Lake
Matt Crooks, ENG,MF,30,13.5,23,16,6,16,1,12,26,46.2,14,19,0,19,8,31,17,0,Matches,Real Salt Lake
Bode Davis,USA,DF,22,13.1,26,22,18,8,0,16,25,64.0,9,15,7,8,14,40,35,0,Matches,Real Salt Lake
Anderson Julio,ECU,FW,28,9.2,5,4,0,1,4,2,13,15.4,11,9,0,9,5,10,6,0,Matches,Real Salt Lake
Gavin Beavers,USA,GK,19,6.0,0,0,0,0,0,0,0,,0,0,0,0,0,0,5,0,Matches,Real Salt Lake
Philip Quinton,USA,DF,24,5.7,12,9,6,6,0,8,12,66.7,4,21,8,13,4,16,29,2,Matches,Real Salt Lake
Fidel Barajas,MEX,FW,18,6.3,5,3,2,1,2,1,4,25.0,3,2,0,2,1,6,2,0,Matches,Real Salt Lake
Bryan Oviedo,CRC,DF,34,6.2,7,6,5,2,0,3,7,42.9,4,7,4,3,11,18,10,0,Matches,Real Salt Lake
Nelson Palacio,COL,MF,23,4.7,7,3,4,3,0,3,11,27.3,8,4,0,4,9,16,10,0,Matches,Real Salt Lake
Marcelo Silva,URU,DF,35,2.0,2,2,2,0,0,1,3,33.3,2,2,2,0,2,4,16,0,Matches,Real Salt Lake
Pablo Ruíz,ARG,MF,25,1.9,0,0,0,0,0,0,2,0.0,2,2,0,2,1,1,0,0,Matches,Real Salt Lake
Maikel Chang,CUB,MF,33,2.2,7,6,3,4,0,3,4,75.0,1,6,0,6,1,8,4,0,Matches,Real Salt Lake
Noel Caliskan,GER,MF,23,1.4,3,2,0,2,1,2,2,100.0,0,1,0,1,2,5,1,0,Matches,Real Salt Lake
Matthew Bell,JAM,FW,21,0.2,2,2,0,2,0,1,1,100.0,0,0,0,0,0,2,0,0,Matches,Real Salt Lake
Tommy Silva,USA,DF,22,0.2,0,0,0,0,0,0,0,,0,0,0,0,2,2,3,0,Matches,Real Salt Lake
Zavier Gozo,USA,FW,17,0.1,0,0,0,0,0,0,0,,0,1,0,1,1,1,0,0,Matches,Real Salt Lake
Hugo Lloris,FRA,GK,37,22.0,1,1,1,0,0,1,2,50.0,1,0,0,0,0,1,8,1,Matches,Los Angeles FC
Denis Bouanga,GAB,FW,29,21.8,21,14,5,4,12,7,20,35.0,13,19,0,19,4,25,9,0,Matches,Los Angeles FC
Mateusz Bogusz,POL,FW,22,20.6,24,15,9,9,6,8,27,29.6,19,4,0,4,7,31,6,0,Matches,Los Angeles FC
Timmy Tillman,GER,MF,25,20.3,58,42,19,24,15,27,50,54.0,23,21,5,16,22,80,18,0,Matches,Los Angeles FC
Eduard Atuesta,COL,MF,27,18.8,34,16,19,12,3,17,47,36.2,30,17,3,14,28,62,12,1,Matches,Los Angeles FC
Aaron Long,USA,DF,31,17.5,22,15,15,7,0,11,16,68.8,5,29,22,7,20,42,85,0,Matches,Los Angeles FC
Jesús David Murillo Largacha,COL,DF,30,17.8,35,22,29,6,0,22,36,61.1,14,23,16,7,25,60,73,1,Matches,Los Angeles FC
Sergi Palencia,ESP,DF,28,17.3,55,35,27,24,4,31,40,77.5,9,24,6,18,20,75,30,0,Matches,Los Angeles FC
Ilie Sánchez,ESP,MF,33,17.3,30,20,14,11,5,17,35,48.6,18,23,13,10,33,63,34,0,Matches,Los Angeles FC
Ryan Hollingshead,USA,DF,33,16.3,53,39,34,14,5,32,44,72.7,12,24,5,19,27,80,39,0,Matches,Los Angeles FC
Cristian Olivera,URU,FW,22,15.0,24,18,7,9,8,11,37,29.7,26,15,1,14,4,28,5,0,Matches,Los Angeles FC
Omar Campos,MEX,DF,21,9.9,15,8,12,3,0,12,27,44.4,15,5,0,5,13,28,21,0,Matches,Los Angeles FC
Maxime Chanot,LUX,DF,34,7.7,10,7,7,3,0,5,8,62.5,3,9,7,2,14,24,45,0,Matches,Los Angeles FC
Kei Kamara,SLE,FW,39,7.0,6,4,2,3,1,4,8,50.0,4,4,3,1,0,6,12,0,Matches,Los Angeles FC
Erik Duenas,USA,MF,19,3.5,12,7,5,6,1,8,17,47.1,9,1,0,1,5,17,2,0,Matches,Los Angeles FC
Eddie Segura,COL,DF,27,4.8,4,1,3,1,0,2,6,33.3,4,5,2,3,8,12,14,1,Matches,Los Angeles FC
Nathan Ordaz,SLV,FW,20,2.0,2,1,1,0,1,1,2,50.0,1,2,0,2,1,3,1,0,Matches,Los Angeles FC
David Martínez,VEN,FW,18,1.4,1,1,0,0,1,0,1,0.0,1,1,0,1,0,1,3,0,Matches,Los Angeles FC
Tomas Ángel,COL,FW,21,0.6,1,1,0,0,1,0,3,0.0,3,0,0,0,0,1,0,0,Matches,Los Angeles FC
Luis Müller,GER,FW,23,0.1,0,0,0,0,0,0,0,,0,0,0,0,1,1,1,0,Matches,Los Angeles FC
Michael Boxall,NZL,DF,35,22.5,25,14,17,5,3,16,22,72.7,6,32,19,13,23,48,111,1,Matches,Minnesota United
Jeong Sangbin,KOR,FW,22,17.9,12,9,6,3,3,6,19,31.6,13,13,0,13,6,18,9,1,Matches,Minnesota United
Robin Lod,FIN,MF,31,17.3,33,23,7,19,7,15,27,55.6,12,9,1,8,11,44,12,0,Matches,Minnesota United
Joseph Rosales,HON,DF,23,17.8,48,25,28,14,6,26,42,61.9,16,19,4,15,41,89,34,0,Matches,Minnesota United
Wil Trapp,USA,MF,31,17.3,37,21,13,20,4,17,34,50.0,17,15,7,8,19,56,21,0,Matches,Minnesota United
D.J. Taylor,USA,DF,26,16.0,37,26,23,10,4,24,37,64.9,13,11,2,9,32,69,51,0,Matches,Minnesota United
Miguel Tapias,MEX,DF,27,16.1,23,16,15,7,1,17,24,70.8,7,18,10,8,17,40,71,1,Matches,Minnesota United
Devin Padelford,USA,DF,21,15.0,30,20,20,8,2,21,31,67.7,10,12,0,12,28,58,51,0,Matches,Minnesota United
Dayne St. Clair,CAN,GK,27,15.0,2,1,2,0,0,2,4,50.0,2,1,0,1,0,2,11,1,Matches,Minnesota United
Hassani Dotson,USA,MF,26,14.6,24,14,9,12,3,8,13,61.5,5,19,2,17,20,44,28,0,Matches,Minnesota United
Bongokuhle Hlongwane,RSA,FW,24,13.2,17,8,4,10,3,5,12,41.7,7,21,6,15,6,23,9,0,Matches,Minnesota United
Caden Clark,USA,DF,21,10.8,28,18,13,11,4,12,23,52.2,11,23,6,17,14,42,13,1,Matches,Minnesota United
Teemu Pukki,FIN,FW,34,9.4,4,0,0,2,2,2,8,25.0,6,14,2,12,2,6,2,0,Matches,Minnesota United
Kervin Arriaga,HON,DF,26,9.8,16,14,11,5,0,9,17,52.9,8,14,7,7,9,25,40,0,Matches,Minnesota United
Franco Fragapane,ARG,MF,31,7.1,10,6,1,6,3,4,12,33.3,8,2,0,2,2,12,2,0,Matches,Minnesota United
Tani Oluwaseyi,CAN,FW,24,6.9,6,4,2,2,2,1,5,20.0,4,9,3,6,3,9,5,0,Matches,Minnesota United
Clint Irwin,USA,GK,35,5.0,0,0,0,0,0,0,0,,0,0,0,0,0,0,5,0,Matches,Minnesota United
Alejandro Bran,CRC,MF,23,4.4,6,2,2,3,1,3,8,37.5,5,7,1,6,5,11,2,0,Matches,Minnesota United
Carlos Harvey,PAN,MF,24,3.6,12,7,6,4,2,3,8,37.5,5,5,3,2,7,19,12,0,Matches,Minnesota United
Alec Smir,USA,GK,25,3.0,0,0,0,0,0,0,0,,0,0,0,0,0,0,4,0,Matches,Minnesota United
Victor Eriksson,SWE,DF,23,1.8,1,1,1,0,0,0,0,,0,0,0,0,0,1,7,1,Matches,Minnesota United
Jordan Adebayo-Smith,NGA,FW,24,2.8,5,3,5,0,0,0,2,0.0,2,4,0,4,2,7,1,0,Matches,Minnesota United
Moses Nyeman,USA,MF,20,1.5,4,1,2,2,0,1,4,25.0,3,3,0,3,4,8,1,0,Matches,Minnesota United
Hugo Bacharach,ESP,DF,22,1.0,2,1,0,2,0,1,2,50.0,1,0,0,0,3,5,2,0,Matches,Minnesota United
Morris Duggan,GER,DF,23,0.5,0,0,0,0,0,0,0,,0,1,1,0,1,1,3,0,Matches,Minnesota United
Loïc Mesanvi,TOG,FW,20,0.5,1,1,0,0,1,0,0,,0,2,0,2,0,1,1,0,Matches,Minnesota United
Zarek Valentin,PUR,DF,32,0.4,0,0,0,0,0,0,0,,0,1,0,1,0,0,3,0,Matches,Minnesota United
Patrick Weah,LBR,FW,20,0.4,0,0,0,0,0,0,0,,0,1,1,0,0,0,0,0,Matches,Minnesota United
Emanuel Reynoso,ARG,MF,28,0.3,1,1,1,0,0,0,0,,0,0,0,0,0,1,0,0,Matches,Minnesota United
Kage Romanshyn,USA,FW,19,0.1,0,0,0,0,0,0,0,,0,0,0,0,0,0,0,0,Matches,Minnesota United
Rory O'Driscoll,USA,FW,24,0.0,0,0,0,0,0,0,0,,0,0,0,0,0,0,0,0,Matches,Minnesota United
Maya Yoshida,JPN,DF,35,23.7,18,10,10,7,1,9,18,50.0,9,32,24,8,32,50,101,3,Matches,LA Galaxy
Miki Yamane,JPN,DF,30,22.7,33,23,21,11,1,17,35,48.6,18,25,8,17,22,55,64,2,Matches,LA Galaxy
John McCarthy,USA,GK,32,22.0,0,0,0,0,0,0,0,,0,0,0,0,0,0,10,3,Matches,LA Galaxy
Marky Delgado,USA,MF,29,21.3,51,32,22,20,9,25,52,48.1,27,36,7,29,25,76,26,2,Matches,LA Galaxy
Gabriel Chaves,BRA,FW,23,20.3,30,20,15,12,3,10,25,40.0,15,22,2,20,17,47,6,0,Matches,LA Galaxy
Julián Aude,ARG,DF,21,18.0,48,29,32,14,2,33,61,54.1,28,31,7,24,20,68,61,1,Matches,LA Galaxy
Riqui Puig,ESP,MF,24,19.2,14,11,8,4,2,5,23,21.7,18,11,2,9,9,23,2,1,Matches,LA Galaxy
Joseph Paintsil,GHA,FW,26,16.9,13,8,6,3,4,5,10,50.0,5,12,2,10,6,19,6,0,Matches,LA Galaxy
Dejan Joveljić,SRB,FW,24,16.3,8,7,3,1,4,4,9,44.4,5,7,0,7,1,9,18,0,Matches,LA Galaxy
Edwin Cerrillo,USA,MF,23,16.1,23,14,15,6,2,13,26,50.0,13,20,8,12,10,33,18,1,Matches,LA Galaxy
Diego Fagúndez,URU,FW,29,14.3,13,6,7,3,3,5,15,33.3,10,11,1,10,5,18,8,0,Matches,LA Galaxy
Martín Cáceres,URU,DF,37,10.7,11,6,10,0,1,6,8,75.0,2,10,8,2,9,20,42,0,Matches,LA Galaxy
Jalen Neal,USA,DF,20,10.4,14,8,7,7,0,7,11,63.6,4,14,12,2,12,26,35,1,Matches,LA Galaxy
Gastón Brugman,URU,MF,31,9.5,28,15,15,9,4,17,24,70.8,7,17,9,8,26,54,18,0,Matches,LA Galaxy
Miguel Berry,ESP,FW,26,7.3,8,1,2,3,3,0,2,0.0,2,8,1,7,1,9,6,0,Matches,LA Galaxy
John Nelson,USA,DF,26,5.1,8,4,3,4,1,4,6,66.7,2,3,2,1,6,14,23,1,Matches,LA Galaxy
Novak Mićović,SRB,GK,22,2.0,0,0,0,0,0,0,0,,0,0,0,0,0,0,1,0,Matches,LA Galaxy
Jonathan Perez,MEX,FW,21,1.5,3,3,1,2,0,3,5,60.0,2,1,0,1,0,3,3,0,Matches,LA Galaxy
Eriq Zavaleta,SLV,DF,31,1.8,3,2,3,0,0,2,2,100.0,0,3,3,0,2,5,9,0,Matches,LA Galaxy
Tucker Lepley,USA,MF,22,0.5,0,0,0,0,0,0,1,0.0,1,2,0,2,1,1,1,0,Matches,LA Galaxy
Mauricio Cuevas,USA,DF,21,2.1,5,3,2,2,1,1,2,50.0,1,3,1,2,2,7,5,0,Matches,LA Galaxy
Daniel Aguirre,USA,MF,25,1.2,5,1,3,1,1,2,5,40.0,3,0,0,0,1,6,3,0,Matches,LA Galaxy
Carlos Garcés,COL,DF,22,0.3,1,0,0,1,0,0,0,,0,0,0,0,0,1,0,0,Matches,LA Galaxy
Isaiah Parente,USA,MF,24,0.3,0,0,0,0,0,0,1,0.0,1,0,0,0,1,1,0,0,Matches,LA Galaxy
Rubén Ramos,USA,FW,17,0.2,0,0,0,0,0,0,0,,0,0,0,0,0,0,0,0,Matches,LA Galaxy
Yohei Takaoka,JPN,GK,28,22.0,0,0,0,0,0,0,0,,0,0,0,0,0,0,8,3,Matches,Vancouver Whitecaps
Ryan Gauld, SCO,FW,28,21.2,47,26,11,26,10,21,41,51.2,20,26,0,26,6,53,10,0,Matches,Vancouver Whitecaps
Brian White,USA,FW,28,19.2,9,4,2,3,4,3,10,30.0,7,12,2,10,6,15,32,0,Matches,Vancouver Whitecaps
Ranko Veselinović,SRB,DF,25,18.7,14,10,11,3,0,6,11,54.5,5,22,11,11,9,23,104,1,Matches,Vancouver Whitecaps
Andrés Cubas,PAR,MF,28,15.4,56,34,20,31,5,20,39,51.3,19,25,4,21,33,89,15,0,Matches,Vancouver Whitecaps
Pedro Vite,ECU,MF,22,15.3,29,23,11,14,4,11,27,40.7,16,15,3,12,18,47,12,1,Matches,Vancouver Whitecaps
Mathías Laborda,URU,DF,24,14.6,32,20,27,5,0,22,39,56.4,17,16,7,9,23,55,46,1,Matches,Vancouver Whitecaps
Alessandro Schöpf,AUT,MF,30,12.8,13,10,5,7,1,8,20,40.0,12,12,2,10,10,23,14,0,Matches,Vancouver Whitecaps
Tristan Blackmon,USA,DF,27,14.0,6,5,5,1,0,4,5,80.0,1,15,9,6,10,16,61,0,Matches,Vancouver Whitecaps
Ryan Raposo,CAN,DF,25,12.1,23,11,17,3,3,11,16,68.8,5,10,7,3,18,41,13,0,Matches,Vancouver Whitecaps
Fafà Picault,HAI,FW,33,11.7,11,6,3,5,3,5,14,35.7,9,16,2,14,8,19,10,0,Matches,Vancouver Whitecaps
Javain Brown,JAM,DF,25,10.8,14,9,8,6,0,10,12,83.3,2,14,8,6,10,24,37,1,Matches,Vancouver Whitecaps
Ali Ahmed,CAN,MF,23,10.7,21,13,10,9,2,13,31,41.9,18,11,0,11,19,40,10,0,Matches,Vancouver Whitecaps
Bjørn Inge Utvik,NOR,DF,28,9.8,12,8,8,3,1,8,10,80.0,2,11,6,5,4,16,46,0,Matches,Vancouver Whitecaps
Sebastian Berhalter,USA,MF,23,11.0,34,19,11,18,5,17,36,47.2,19,20,4,16,11,45,20,1,Matches,Vancouver Whitecaps
Luís Martins,POR,DF,32,7.9,8,6,5,2,1,5,10,50.0,5,6,1,5,8,16,11,0,Matches,Vancouver Whitecaps
Damir Kreilach,CRO,FW,35,4.2,1,1,0,1,0,1,3,33.3,2,2,0,2,2,3,6,0,Matches,Vancouver Whitecaps
Levonte Johnson,CAN,FW,25,3.9,6,6,5,1,0,2,3,66.7,1,4,0,4,1,7,1,0,Matches,Vancouver Whitecaps
Sam Adekugbe,CAN,MF,29,2.7,3,1,2,1,0,1,1,100.0,0,1,0,1,2,5,5,0,Matches,Vancouver Whitecaps
Giuseppe Bovalina,AUS,DF,19,1.8,2,2,1,1,0,1,1,100.0,0,0,0,0,0,2,4,0,Matches,Vancouver Whitecaps
Ralph Priso-Mbongue,CAN,MF,21,0.9,3,1,2,1,0,2,4,50.0,2,4,1,3,0,3,2,0,Matches,Vancouver Whitecaps
Nicolas Fleuriau,CAN,FW,22,0.1,0,0,0,0,0,0,0,,0,0,0,0,0,0,0,0,Matches,Vancouver Whitecaps
Jay Herdman,NZL,FW,19,0.1,0,0,0,0,0,0,0,,0,0,0,0,0,0,0,0,Matches,Vancouver Whitecaps
Cyprian Kachwele,TAN,MF,19,0.0,0,0,0,0,0,0,0,,0,0,0,0,0,0,0,0,Matches,Vancouver Whitecaps
Brad Stuver,USA,GK,33,23.0,0,0,0,0,0,0,2,0.0,2,0,0,0,0,0,18,2,Matches,Austin FC
Jáder Obrian,COL,FW,29,17.4,20,8,10,6,4,9,33,27.3,24,28,2,26,10,30,7,0,Matches,Austin FC
Alexander Ring,FIN,MF,33,20.7,35,20,21,9,5,12,46,26.1,34,21,13,8,24,59,37,1,Matches,Austin FC
Jon Gallagher,IRL,DF,28,19.9,33,26,23,8,2,17,33,51.5,16,19,6,13,11,44,38,0,Matches,Austin FC
Diego Rubio,CHI,FW,31,16.3,22,14,8,9,5,13,28,46.4,15,17,1,16,7,29,6,0,Matches,Austin FC
Brendan Hines-Ike,USA,DF,29,18.4,20,12,14,5,1,11,15,73.3,4,26,23,3,6,26,62,1,Matches,Austin FC
Sebastián Driussi,ARG,MF,28,16.5,16,11,8,3,5,5,16,31.3,11,12,1,11,4,20,12,1,Matches,Austin FC
Guilherme Biro,BRA,DF,24,15.8,33,20,15,10,8,16,24,66.7,8,21,5,16,16,49,37,0,Matches,Austin FC
Daniel Pereira,VEN,MF,24,14.6,18,8,6,9,3,8,20,40.0,12,16,4,12,16,34,11,1,Matches,Austin FC
Julio Cascante,CRC,DF,30,13.7,19,15,12,7,0,10,21,47.6,11,17,14,3,16,35,52,0,Matches,Austin FC
Owen Wolff,USA,FW,19,14.3,17,9,8,4,5,12,21,57.1,9,15,5,10,4,21,21,0,Matches,Austin FC
Jhojan Valencia,COL,MF,27,11.1,25,16,10,12,3,8,23,34.8,15,9,4,5,10,35,23,0,Matches,Austin FC
Leo Väisänen,FIN,DF,26,7.9,12,7,9,3,0,6,8,75.0,2,11,9,2,5,17,35,1,Matches,Austin FC
Ethan Finlay,USA,FW,33,7.8,12,6,4,4,4,7,14,50.0,7,6,1,5,0,12,8,0,Matches,Austin FC
Emiliano Rigoni,ARG,FW,31,7.8,8,4,5,2,1,6,10,60.0,4,10,5,5,4,12,10,0,Matches,Austin FC
Gyasi Zardes,USA,FW,32,8.9,15,12,7,7,1,6,9,66.7,3,5,2,3,5,20,15,1,Matches,Austin FC
Matt Hedges,USA,DF,34,6.2,5,2,5,0,0,4,4,100.0,0,10,7,3,8,13,37,0,Matches,Austin FC
Žan Kolmanič,SVN,DF,24,5.6,10,9,7,1,2,3,5,60.0,2,1,1,0,2,12,18,0,Matches,Austin FC
Hector Jiménez,USA,DF,35,4.7,6,3,4,1,1,2,9,22.2,7,5,1,4,8,14,7,0,Matches,Austin FC
CJ Fodrey,USA,FW,20,1.9,4,2,0,2,2,1,4,25.0,3,1,0,1,1,5,0,0,Matches,Austin FC
Alonso Ramírez,MEX,MF,22,0.3,0,0,0,0,0,0,0,,0,0,0,0,1,1,0,0,Matches,Austin FC
Bryant Farkarlun,USA,FW,23,0.1,0,0,0,0,0,0,0,,0,0,0,0,0,0,0,0,Matches,Austin FC
Artur,BRA,MF,28,21.9,47,33,23,21,3,26,46,56.5,20,25,7,18,12,59,36,2,Matches,Houston Dynamo
Aliyu Ibrahim,NGA,FW,22,20.6,26,18,8,8,10,12,26,46.2,14,16,1,15,7,33,13,0,Matches,Houston Dynamo
Griffin Dorsey,USA,DF,25,18.8,27,17,14,10,3,13,24,54.2,11,12,4,8,9,36,39,0,Matches,Houston Dynamo
Micael,BRA,DF,23,19.8,32,21,26,6,0,17,29,58.6,12,27,21,6,22,54,89,1,Matches,Houston Dynamo
Steve Clark,USA,GK,38,18.8,0,0,0,0,0,0,0,,0,0,0,0,0,0,8,1,Matches,Houston Dynamo
Amine Bassi,FRA,MF,26,18.3,10,6,1,5,4,5,14,35.7,9,11,0,11,4,14,4,0,Matches,Houston Dynamo
Adalberto Carrasquilla,PAN,FW,25,16.6,21,12,5,12,4,14,25,56.0,11,13,3,10,10,31,6,1,Matches,Houston Dynamo
Sebastian Kowalczyk,POL,FW,25,16.3,12,8,2,4,6,6,13,46.2,7,17,1,16,10,22,6,0,Matches,Houston Dynamo
Erik Sviatchenko,DEN,DF,32,15.2,15,11,11,3,1,6,9,66.7,3,12,10,2,17,32,49,1,Matches,Houston Dynamo
Héctor Herrera,MEX,MF,34,12.0,16,9,7,7,2,10,23,43.5,13,9,0,9,12,28,11,2,Matches,Houston Dynamo
Franco Escobar,ARG,DF,29,10.7,48,29,27,14,7,34,50,68.0,16,15,1,14,13,61,17,0,Matches,Houston Dynamo
Latif Blessing,GHA,FW,27,8.0,14,11,7,6,1,3,10,30.0,7,6,0,6,7,21,7,1,Matches,Houston Dynamo
Daniel Steres,USA,DF,33,9.5,23,17,16,5,2,13,15,86.7,2,9,2,7,5,28,26,1,Matches,Houston Dynamo
Ethan Bartlow,USA,DF,24,8.4,16,10,13,3,0,11,14,78.6,3,16,10,6,3,19,38,0,Matches,Houston Dynamo
Sebastián Ferreira,PAR,FW,26,5.3,5,3,0,3,2,1,8,12.5,7,5,1,4,0,5,2,0,Matches,Houston Dynamo
Tate Schmitt,USA,DF,27,4.7,7,6,6,1,0,5,8,62.5,3,5,1,4,5,12,8,1,Matches,Houston Dynamo
Ján Greguš,SVK,MF,33,4.2,4,4,1,3,0,1,4,25.0,3,3,0,3,4,8,1,1,Matches,Houston Dynamo
Andrew Tarbell,USA,GK,30,3.2,0,0,0,0,0,0,0,,0,0,0,0,0,0,2,0,Matches,Houston Dynamo
Brooklyn Raines,USA,MF,19,2.8,4,3,3,1,0,0,1,0.0,1,3,0,3,0,4,1,1,Matches,Houston Dynamo
Gabe Segal,USA,FW,23,2.1,2,1,0,2,0,1,3,33.3,2,1,0,1,0,2,2,0,Matches,Houston Dynamo
Brad Smith,AUS,FW,30,3.6,7,3,5,1,1,3,9,33.3,6,3,1,2,0,7,7,0,Matches,Houston Dynamo
McKinze Gaines,USA,MF,26,0.2,0,0,0,0,0,0,0,,0,0,0,0,0,0,0,0,Matches,Houston Dynamo
Jefferson Valverde,ECU,DF,25,0.1,0,0,0,0,0,0,1,0.0,1,0,0,0,0,0,0,0,Matches,Houston Dynamo
Andreas Maxsø,DEN,DF,30,24.0,19,12,14,5,0,10,15,66.7,5,30,23,7,17,36,103,0,Matches,Colorado Rapids
Zack Steffen,USA,GK,29,24.0,1,0,1,0,0,1,2,50.0,1,0,0,0,0,1,15,1,Matches,Colorado Rapids
Cole Bassett,USA,MF,22,23.8,55,30,22,26,7,31,66,47.0,35,29,3,26,18,73,24,2,Matches,Colorado Rapids
Rafael Navarro,BRA,FW,24,21.1,38,23,10,19,9,9,22,40.9,13,35,3,32,6,44,7,0,Matches,Colorado Rapids
Keegan Rosenberry,USA,DF,30,21.7,23,14,16,5,2,15,23,65.2,8,30,12,18,35,58,52,0,Matches,Colorado Rapids
Sam Vines,USA,DF,25,20.6,22,12,17,3,2,19,31,61.3,12,25,6,19,22,44,40,1,Matches,Colorado Rapids
Djordje Mihailovic,USA,MF,25,20.4,15,14,2,7,6,10,23,43.5,13,16,2,14,11,26,7,0,Matches,Colorado Rapids
Oliver Larraz,USA,MF,22,17.3,45,25,15,25,5,22,50,44.0,28,25,4,21,25,70,21,0,Matches,Colorado Rapids
Kevin Cabral,FRA,FW,25,13.8,13,6,5,6,2,5,20,25.0,15,16,2,14,12,25,14,1,Matches,Colorado Rapids
Moïse Bombito,CAN,DF,24,15.2,27,19,18,8,1,15,19,78.9,4,13,9,4,19,46,65,1,Matches,Colorado Rapids
Omir Fernandez,USA,FW,25,13.8,21,13,5,10,6,10,20,50.0,10,14,1,13,10,31,8,0,Matches,Colorado Rapids
Calvin Harris, ENG,FW,24,11.5,15,8,3,8,4,12,28,42.9,16,13,1,12,0,15,4,1,Matches,Colorado Rapids
Connor Ronan,IRL,MF,26,10.6,19,12,9,8,2,11,28,39.3,17,9,0,9,12,31,9,0,Matches,Colorado Rapids
Lalas Abubakar,GHA,DF,29,7.7,4,3,3,1,0,2,2,100.0,0,5,5,0,11,15,38,0,Matches,Colorado Rapids
Darren Yapi,USA,FW,19,5.6,11,6,2,6,3,3,7,42.9,4,5,0,5,2,13,2,0,Matches,Colorado Rapids
Sebastian Anderson,USA,DF,21,3.6,4,3,3,1,0,3,10,30.0,7,5,1,4,6,10,11,0,Matches,Colorado Rapids
Jackson Travis,USA,DF,20,1.7,4,2,2,0,2,1,2,50.0,1,2,0,2,0,4,5,0,Matches,Colorado Rapids
Jasper Löffelsend,GER,MF,26,2.5,13,6,7,6,0,9,14,64.3,5,4,1,3,2,15,4,1,Matches,Colorado Rapids
Michael Edwards,USA,DF,23,1.3,3,2,3,0,0,3,4,75.0,1,1,0,1,3,6,2,0,Matches,Colorado Rapids
Jonathan Lewis,USA,FW,27,2.4,5,3,2,2,1,1,2,50.0,1,2,0,2,0,5,1,0,Matches,Colorado Rapids
Kimani Stewart-Baynes,CAN,MF,19,0.7,3,1,0,2,1,3,5,60.0,2,1,0,1,0,3,0,0,Matches,Colorado Rapids
Lamine Diack,SEN,FW,23,0.2,3,2,3,0,0,1,1,100.0,0,0,0,0,2,5,0,0,Matches,Colorado Rapids
Wayne Frederick,TRI,MF,20,0.0,0,0,0,0,0,0,0,,0,0,0,0,0,0,1,0,Matches,Colorado Rapids
Juan David Mosquera,COL,DF,21,21.2,41,28,27,9,5,20,45,44.4,25,22,3,19,13,54,40,1,Matches,Portland Timbers
Santiago Moreno,COL,FW,24,18.8,43,29,10,19,14,17,33,51.5,16,29,2,27,12,55,6,0,Matches,Portland Timbers
Diego Chará,COL,MF,38,19.0,54,34,26,26,2,24,33,72.7,9,13,3,10,26,80,25,2,Matches,Portland Timbers
Jonathan Rodríguez,URU,FW,31,18.9,13,9,5,6,2,6,11,54.5,5,12,0,12,5,18,17,0,Matches,Portland Timbers
Evander,BRA,MF,26,18.3,24,16,8,8,8,13,28,46.4,15,15,1,14,3,27,6,0,Matches,Portland Timbers
Dario Župarić,BIH,DF,32,16.0,32,20,25,5,2,17,25,68.0,8,25,13,12,19,51,80,1,Matches,Portland Timbers
Antony,BRA,FW,22,15.1,33,24,13,13,7,11,25,44.0,14,17,1,16,13,46,11,0,Matches,Portland Timbers
Kamal Miller,CAN,DF,27,15.0,12,8,11,1,0,10,13,76.9,3,18,13,5,13,25,63,1,Matches,Portland Timbers
Felipe Mora,CHI,FW,30,13.7,3,1,0,1,2,0,2,0.0,2,7,2,5,3,6,9,0,Matches,Portland Timbers
Maxime Crépeau,CAN,GK,30,12.5,0,0,0,0,0,0,1,0.0,1,0,0,0,1,1,8,3,Matches,Portland Timbers
Claudio Bravo,ARG,DF,27,11.5,37,23,20,14,3,24,43,55.8,19,25,6,19,15,52,36,0,Matches,Portland Timbers
David Ayala,ARG,MF,21,10.0,36,22,20,11,5,15,34,44.1,19,13,1,12,17,53,24,1,Matches,Portland Timbers
Cristhian Paredes,PAR,MF,26,12.3,23,15,9,10,4,10,31,32.3,21,24,4,20,16,39,21,0,Matches,Portland Timbers
James Pantemis,CAN,GK,27,11.5,0,0,0,0,0,0,0,,0,1,0,1,0,0,13,1,Matches,Portland Timbers
Miguel Araujo,PER,DF,29,10.8,21,14,10,11,0,8,13,61.5,5,14,9,5,11,32,49,0,Matches,Portland Timbers
Zac McGraw,CAN,DF,27,9.4,12,9,6,5,1,8,12,66.7,4,20,14,6,10,22,70,1,Matches,Portland Timbers
Eric Miller,USA,DF,31,10.4,15,13,3,9,3,5,5,100.0,0,10,4,6,8,23,31,0,Matches,Portland Timbers
Eryk Williamson,USA,MF,27,8.7,14,9,5,7,2,4,11,36.4,7,3,2,1,7,21,3,0,Matches,Portland Timbers
Dairon Asprilla,COL,FW,32,7.6,11,2,6,4,1,5,14,35.7,9,5,0,5,5,16,13,0,Matches,Portland Timbers
Nathan Fogaça,BRA,FW,25,2.0,0,0,0,0,0,0,2,0.0,2,1,0,1,2,2,2,0,Matches,Portland Timbers
Larrys Mabiala,COD,DF,36,0.5,0,0,0,0,0,0,0,,0,2,1,1,0,0,1,1,Matches,Portland Timbers
Victor Enriquez,,MF,,0.1,0,0,0,0,0,0,0,,0,1,0,1,0,0,0,0,Matches,Portland Timbers
Sawyer Jura,USA,DF,18,0.0,1,0,0,1,0,1,1,100.0,0,0,0,0,0,1,0,0,Matches,Portland Timbers
Jackson Ragen,USA,DF,25,21.2,16,11,12,4,0,7,12,58.3,5,22,12,10,22,38,81,3,Matches,Seattle Sounders
Cristian Roldan,USA,MF,29,21.1,47,30,18,22,7,27,41,65.9,14,26,3,23,18,65,30,0,Matches,Seattle Sounders
Jordan Morris,USA,FW,29,20.2,19,11,6,7,6,10,14,71.4,4,10,2,8,5,24,14,0,Matches,Seattle Sounders
Obed Vargas,USA,MF,18,19.7,50,29,15,24,11,17,33,51.5,16,37,13,24,21,71,25,1,Matches,Seattle Sounders
Stefan Frei,SUI,GK,38,18.3,0,0,0,0,0,0,0,,0,0,0,0,0,0,3,2,Matches,Seattle Sounders
Yeimar Gómez Andrade,COL,DF,32,17.6,31,21,21,9,1,15,21,71.4,6,26,14,12,32,63,87,1,Matches,Seattle Sounders
Albert Rusnák,SVK,MF,30,17.6,9,8,1,5,3,4,10,40.0,6,8,0,8,12,21,5,0,Matches,Seattle Sounders
Nouhou Tolo,CMR,DF,27,16.4,20,13,15,5,0,13,24,54.2,11,18,9,9,22,42,51,0,Matches,Seattle Sounders
Alex Roldan,SLV,DF,27,15.0,31,23,16,12,3,16,26,61.5,10,18,7,11,11,42,29,0,Matches,Seattle Sounders
Raúl Ruidíaz,PER,FW,33,13.9,6,3,1,3,2,1,4,25.0,3,9,2,7,1,7,5,0,Matches,Seattle Sounders
João Paulo Mior,BRA,MF,33,12.7,21,13,9,8,4,9,25,36.0,16,18,4,14,27,48,16,0,Matches,Seattle Sounders
Léo Chú,BRA,FW,24,7.1,17,9,8,5,4,2,6,33.3,4,10,0,10,3,20,2,0,Matches,Seattle Sounders
Joshua Atencio,USA,MF,22,9.3,30,15,11,12,7,16,34,47.1,18,24,2,22,19,49,10,0,Matches,Seattle Sounders
Cody Baker,USA,DF,20,5.3,16,14,9,5,2,10,12,83.3,2,4,1,3,4,20,14,0,Matches,Seattle Sounders
Daniel Musovski,USA,FW,28,5.3,11,7,4,6,1,3,6,50.0,3,4,1,3,1,12,4,0,Matches,Seattle Sounders
Andrew Thomas,RUS,GK,25,4.7,0,0,0,0,0,0,1,0.0,1,0,0,0,0,0,3,0,Matches,Seattle Sounders
Jon Bell,JAM,DF,26,3.9,6,3,3,2,1,3,4,75.0,1,7,5,2,2,8,22,0,Matches,Seattle Sounders
Paul Rothrock,USA,FW,25,5.6,6,5,3,3,0,4,7,57.1,3,8,0,8,5,11,3,0,Matches,Seattle Sounders
Reed Baker-Whiting,USA,DF,19,4.6,12,5,8,3,1,9,14,64.3,5,13,1,12,7,19,14,1,Matches,Seattle Sounders
Xavier Arreaga,ECU,DF,29,2.8,4,3,2,2,0,2,5,40.0,3,5,3,2,6,10,7,1,Matches,Seattle Sounders
Danny Leyva,USA,MF,21,2.0,3,2,2,1,0,0,2,0.0,2,5,0,5,5,8,6,0,Matches,Seattle Sounders
Pedro De la Vega,ARG,MF,23,1.9,3,2,0,3,0,1,2,50.0,1,3,1,2,0,3,1,0,Matches,Seattle Sounders
Sota Kitahara,USA,DF,21,1.6,3,1,2,0,1,2,3,66.7,1,0,0,0,1,4,3,0,Matches,Seattle Sounders
Georgi Minoungou,CIV,FW,21,1.1,2,1,1,0,1,1,2,50.0,1,1,0,1,0,2,0,0,Matches,Seattle Sounders
Dylan Teves,USA,MF,24,1.0,3,1,1,2,0,2,3,66.7,1,1,0,1,0,3,1,0,Matches,Seattle Sounders
Nathan Cardoso,BRA,DF,29,0.8,2,2,2,0,0,1,1,100.0,0,4,3,1,0,2,9,0,Matches,Seattle Sounders
Kalani Rienzi,USA,DF,22,0.1,2,0,2,0,0,2,3,66.7,1,0,0,0,0,2,1,0,Matches,Seattle Sounders
Antino Lopez,USA,MF,22,0.1,0,0,0,0,0,0,0,,0,0,0,0,0,0,0,0,Matches,Seattle Sounders
Roman Bürki,SUI,GK,33,21.3,0,0,0,0,0,0,1,0.0,1,0,0,0,0,0,6,2,Matches,St Louis City
Tomas Totland,NOR,DF,25,20.7,36,17,18,14,4,25,38,65.8,13,25,9,16,36,72,50,1,Matches,St Louis City
Chris Durkin,USA,MF,24,20.4,55,37,22,23,10,33,49,67.3,16,29,2,27,30,85,25,1,Matches,St Louis City
Indiana Vassilev,USA,MF,23,18.0,18,12,4,10,4,9,32,28.1,23,24,1,23,5,23,7,0,Matches,St Louis City
Tim Parker,USA,DF,31,17.9,17,13,10,5,2,9,12,75.0,3,14,10,4,16,33,48,0,Matches,St Louis City
Klauss,BRA,FW,27,15.9,13,7,2,6,5,7,14,50.0,7,10,1,9,3,16,14,0,Matches,St Louis City
Anthony Markanich,PHI,DF,24,14.3,35,18,17,14,4,16,34,47.1,18,27,5,22,26,61,52,1,Matches,St Louis City
Célio Pompeu,BRA,FW,24,13.8,26,16,7,11,8,15,30,50.0,15,20,1,19,8,34,8,0,Matches,St Louis City
Eduard Löwen,GER,MF,27,10.9,19,12,6,13,0,12,26,46.2,14,11,1,10,5,24,4,1,Matches,St Louis City
Joakim Nilsson,SWE,DF,30,9.7,25,15,16,8,1,16,31,51.6,15,9,4,5,15,40,49,1,Matches,St Louis City
Njabulo Blom,RSA,MF,24,8.7,16,12,6,8,2,8,13,61.5,5,8,1,7,15,31,2,1,Matches,St Louis City
Aziel Jackson,USA,FW,22,8.9,15,9,5,7,3,5,13,38.5,8,8,0,8,6,21,4,0,Matches,St Louis City
Tomáš Ostrák,CZE,MF,24,7.7,13,6,3,5,5,5,17,29.4,12,11,1,10,10,23,7,0,Matches,St Louis City
Rasmus Alm,SWE,FW,28,6.0,11,6,3,5,3,6,14,42.9,8,8,0,8,4,15,4,0,Matches,St Louis City
Hosei Kijima,JPN,MF,22,7.5,18,11,4,11,3,6,12,50.0,6,15,0,15,9,27,4,0,Matches,St Louis City
Nökkvi Þórisson,ISL,FW,24,8.0,9,5,4,2,3,2,7,28.6,5,6,0,6,2,11,6,0,Matches,St Louis City
Joshua Yaro,GHA,DF,29,7.3,8,7,5,3,0,5,5,100.0,0,13,10,3,13,21,30,1,Matches,St Louis City
Kyle Hiebert,CAN,DF,26,7.2,11,8,6,4,1,9,15,60.0,6,10,6,4,4,15,16,0,Matches,St Louis City
Akil Watts,USA,DF,24,5.7,21,16,10,6,5,15,21,71.4,6,13,5,8,4,25,8,0,Matches,St Louis City
Samuel Adeniran,USA,FW,25,6.6,3,1,2,0,1,0,0,,0,3,1,2,2,5,6,0,Matches,St Louis City
John Klein,USA,FW,24,4.5,11,5,3,5,3,3,8,37.5,5,3,0,3,1,12,3,0,Matches,St Louis City
Jayden Reid,USA,DF,22,4.0,5,2,3,1,1,5,5,100.0,0,9,1,8,4,9,11,0,Matches,St Louis City
Jake Nerwinski,USA,DF,29,2.4,4,2,1,3,0,2,4,50.0,2,4,3,1,6,10,12,1,Matches,St Louis City
Michael Wentzel,GER,DF,22,1.9,3,1,2,1,0,1,4,25.0,3,2,1,1,0,3,15,0,Matches,St Louis City
Nikolas Dyhr,DEN,DF,23,1.5,2,1,1,1,0,2,4,50.0,2,1,0,1,0,2,5,0,Matches,St Louis City
Benjamin Lundt,GER,GK,28,1.7,0,0,0,0,0,0,0,,0,0,0,0,0,0,0,0,Matches,St Louis City
Caden Glover,USA,FW,17,0.4,0,0,0,0,0,0,0,,0,0,0,0,0,0,1,0,Matches,St Louis City
Brendan McSorley,USA,FW,22,0.1,0,0,0,0,0,0,0,,0,0,0,0,0,0,0,0,Matches,St Louis City
Cristian Espinoza,ARG,FW,29,22.1,21,9,7,5,9,10,38,26.3,28,24,0,24,11,32,25,0,Matches,San Jose Earthquakes
Rodrigues,BRA,DF,26,20.6,35,20,32,2,1,24,47,51.1,23,20,12,8,26,61,84,1,Matches,San Jose Earthquakes
Jackson Yueill,USA,MF,27,19.7,36,20,7,26,3,19,35,54.3,16,9,1,8,16,52,28,1,Matches,San Jose Earthquakes
Jeremy Ebobisse,USA,FW,27,16.2,9,6,2,3,4,3,5,60.0,2,10,1,9,4,13,12,0,Matches,San Jose Earthquakes
Vitor Costa,BRA,DF,30,18.1,66,37,35,27,4,36,59,61.0,23,23,5,18,21,87,72,1,Matches,San Jose Earthquakes
William Yarbrough,USA,GK,35,17.0,0,0,0,0,0,0,0,,0,0,0,0,0,0,8,1,Matches,San Jose Earthquakes
Amahl Pellegrino,NOR,FW,34,12.8,11,5,3,7,1,5,13,38.5,8,11,1,10,11,22,8,0,Matches,San Jose Earthquakes
Carlos Gruezo,ECU,MF,29,13.2,26,11,11,14,1,11,25,44.0,14,11,1,10,18,44,24,1,Matches,San Jose Earthquakes
Niko Tsakiris,USA,MF,19,11.5,22,14,12,7,3,11,21,52.4,10,15,4,11,8,30,14,0,Matches,San Jose Earthquakes
Carlos Akapo,EQG,DF,31,12.0,33,20,18,9,6,16,31,51.6,15,13,3,10,25,58,47,0,Matches,San Jose Earthquakes
Tanner Beason,USA,DF,27,12.3,12,5,10,2,0,8,10,80.0,2,22,17,5,12,24,71,0,Matches,San Jose Earthquakes
Paul Marie,FRA,DF,29,11.5,35,26,21,8,6,28,53,52.8,25,20,5,15,16,51,45,0,Matches,San Jose Earthquakes
Hernán López Muñoz,ARG,MF,23,11.2,28,17,9,12,7,6,25,24.0,19,12,0,12,9,37,4,0,Matches,San Jose Earthquakes
Bruno Wilson,POR,DF,27,9.6,6,3,5,1,0,2,5,40.0,3,14,13,1,17,23,51,0,Matches,San Jose Earthquakes
Benjamin Kikanovic,USA,FW,24,9.6,15,6,10,5,0,7,19,36.8,12,14,2,12,3,18,10,0,Matches,San Jose Earthquakes
Daniel Munie,USA,DF,24,7.9,8,6,7,1,0,5,11,45.5,6,17,10,7,10,18,30,0,Matches,San Jose Earthquakes
Preston Judd,USA,FW,25,7.0,5,2,2,2,1,0,3,0.0,3,10,1,9,1,6,3,0,Matches,San Jose Earthquakes
Jack Skahan,USA,MF,26,6.8,4,3,2,2,0,2,8,25.0,6,6,0,6,0,4,1,0,Matches,San Jose Earthquakes
Alfredo Morales,USA,MF,34,5.7,12,5,7,5,0,4,5,80.0,1,4,1,3,4,16,8,0,Matches,San Jose Earthquakes
Daniel,BRA,GK,30,4.0,0,0,0,0,0,0,1,0.0,1,0,0,0,0,0,3,0,Matches,San Jose Earthquakes
Jacob Jackson,USA,GK,24,2.0,0,0,0,0,0,0,0,,0,0,0,0,0,0,1,1,Matches,San Jose Earthquakes
Ousseni Bouda,BFA,FW,24,0.8,1,0,0,1,0,1,1,100.0,0,1,0,1,1,2,1,0,Matches,San Jose Earthquakes
Jamar Ricketts,USA,MF,22,0.4,2,2,1,1,0,1,3,33.3,2,0,0,0,0,2,2,0,Matches,San Jose Earthquakes
Tommy Thompson,USA,DF,28,0.3,2,1,0,2,0,1,2,50.0,1,0,0,0,1,3,0,0,Matches,San Jose Earthquakes
Michael Baldisimo,PHI,MF,24,0.1,3,0,1,2,0,2,3,66.7,1,0,0,0,2,5,1,0,Matches,San Jose Earthquakes
Nemanja Radoja,SRB,MF,31,21.1,39,23,14,24,1,19,33,57.6,14,22,3,19,17,56,26,1,Matches,Sporting Kansas City
Tim Melia,USA,GK,38,21.0,0,0,0,0,0,0,0,,0,0,0,0,1,1,9,2,Matches,Sporting Kansas City
Jake Davis,USA,DF,22,19.7,58,30,20,31,7,23,53,43.4,30,30,6,24,21,79,34,1,Matches,Sporting Kansas City
Erik Thommy,GER,MF,29,19.0,24,16,4,13,7,13,29,44.8,16,26,3,23,9,33,9,1,Matches,Sporting Kansas City
Daniel Rosero,COL,DF,30,17.0,21,15,13,8,0,8,14,57.1,6,19,11,8,19,40,77,1,Matches,Sporting Kansas City
Tim Leibold,GER,DF,30,17.1,44,29,28,11,5,27,47,57.4,20,17,2,15,20,64,26,1,Matches,Sporting Kansas City
Alan Pulido,MEX,FW,33,16.3,12,3,0,8,4,2,10,20.0,8,3,0,3,5,17,3,0,Matches,Sporting Kansas City
Dániel Sallói,HUN,FW,27,16.5,16,8,5,8,3,8,11,72.7,3,17,0,17,8,24,9,0,Matches,Sporting Kansas City
Andreu Fontàs,ESP,DF,34,14.2,20,12,11,8,1,11,31,35.5,20,20,6,14,24,44,41,0,Matches,Sporting Kansas City
Memo Rodriguez,USA,MF,28,13.3,38,18,14,19,5,18,39,46.2,21,8,1,7,19,57,7,0,Matches,Sporting Kansas City
Johnny Russell, SCO,FW,34,14.4,27,17,15,7,5,13,25,52.0,12,23,1,22,8,35,11,0,Matches,Sporting Kansas City
William Agada,NGA,FW,24,12.1,5,2,1,2,2,0,2,0.0,2,2,0,2,4,9,3,1,Matches,Sporting Kansas City
Robert Voloder,BIH,DF,23,10.6,19,10,13,4,2,7,15,46.7,8,18,8,10,16,35,35,2,Matches,Sporting Kansas City
Rémi Walter,FRA,MF,29,8.5,9,4,3,5,1,5,8,62.5,3,2,1,1,7,16,12,0,Matches,Sporting Kansas City
Robert Castellanos,USA,DF,26,7.3,3,2,3,0,0,1,2,50.0,1,7,7,0,7,10,39,0,Matches,Sporting Kansas City
Zorhan Bassong,CAN,DF,25,6.9,21,16,15,5,1,9,11,81.8,2,8,3,5,7,28,15,0,Matches,Sporting Kansas City
Kayden Pierre,USA,DF,21,4.5,8,6,3,3,2,4,6,66.7,2,4,2,2,6,14,12,0,Matches,Sporting Kansas City
Alenis Vargas,HON,FW,20,5.0,3,2,0,1,2,2,7,28.6,5,2,1,1,3,6,1,0,Matches,Sporting Kansas City
Stephen Afrifa,CAN,FW,23,4.2,10,4,9,0,1,4,5,80.0,1,12,0,12,1,11,4,0,Matches,Sporting Kansas City
Marinos Tzionis,CYP,FW,22,3.1,6,3,0,2,4,0,1,0.0,1,6,1,5,3,9,2,0,Matches,Sporting Kansas City
Khiry Shelton,USA,DF,31,5.1,10,5,7,3,0,3,8,37.5,5,7,0,7,3,13,9,1,Matches,Sporting Kansas City
John Pulskamp,USA,GK,23,3.0,0,0,0,0,0,0,0,,0,0,0,0,0,0,1,0,Matches,Sporting Kansas City
Felipe Hernandez,USA,MF,26,4.2,4,1,2,2,0,1,5,20.0,4,10,1,9,2,6,1,0,Matches,Sporting Kansas City
Maarten Paes,NED,GK,26,23.0,0,0,0,0,0,0,0,,0,0,0,0,0,0,10,5,Matches,FC Dallas
Sebastien Ibeagha,USA,DF,32,20.0,20,16,14,5,1,12,16,75.0,4,15,11,4,16,36,83,2,Matches,FC Dallas
Petar Musa,CRO,FW,26,19.7,9,3,3,4,2,2,10,20.0,8,18,2,16,7,16,23,1,Matches,FC Dallas
Sam Junqua,USA,DF,27,19.0,30,22,20,6,4,19,26,73.1,7,20,11,9,23,53,46,0,Matches,FC Dallas
Nkosi Tafari,USA,DF,27,18.3,25,20,16,6,3,11,16,68.8,5,21,17,4,16,41,73,1,Matches,FC Dallas
Paul Arriola,USA,DF,29,17.8,28,18,15,10,3,16,35,45.7,19,20,2,18,5,33,19,0,Matches,FC Dallas
Liam Fraser,CAN,MF,26,15.3,19,11,8,9,2,14,21,66.7,7,20,11,9,13,32,20,1,Matches,FC Dallas
Asier Illarramendi,ESP,MF,34,13.8,41,27,15,20,6,24,48,50.0,24,28,5,23,20,61,24,0,Matches,FC Dallas
Marco Farfan,USA,DF,25,11.6,29,17,15,11,3,15,19,78.9,4,9,4,5,14,43,19,0,Matches,FC Dallas
Ema Twumasi,GHA,DF,27,11.3,18,11,11,5,2,10,19,52.6,9,8,4,4,3,21,23,1,Matches,FC Dallas
Patrickson Delgado,ECU,MF,20,11.0,20,15,7,8,5,8,17,47.1,9,16,2,14,18,38,11,0,Matches,FC Dallas
Sebastian Lletget,USA,MF,31,11.7,21,13,9,11,1,8,14,57.1,6,11,2,9,10,31,15,0,Matches,FC Dallas
Bernard Kamungo,USA,MF,22,9.9,13,10,4,5,4,5,15,33.3,10,10,1,9,5,18,10,0,Matches,FC Dallas
Dante Sealy,USA,DF,21,9.5,14,8,5,5,4,8,12,66.7,4,5,1,4,11,25,15,0,Matches,FC Dallas
Jesús Ferreira,USA,MF,23,9.0,9,6,6,3,0,4,11,36.4,7,5,0,5,5,14,2,0,Matches,FC Dallas
Omar Gonzalez,USA,DF,35,7.8,4,2,3,1,0,1,2,50.0,1,12,9,3,3,7,36,1,Matches,FC Dallas
Tsiki Ntsabeleng,RSA,MF,26,6.6,10,4,3,6,1,4,10,40.0,6,4,0,4,5,15,3,0,Matches,FC Dallas
Logan Farrington,USA,FW,22,7.5,8,5,2,5,1,1,8,12.5,7,9,1,8,4,12,8,0,Matches,FC Dallas
Eugene Ansah,GHA,FW,29,4.4,5,5,2,3,0,1,1,100.0,0,1,0,1,2,7,4,0,Matches,FC Dallas
Nolan Norris,USA,MF,19,2.2,4,1,3,1,0,2,2,100.0,0,2,1,1,2,6,7,0,Matches,FC Dallas
Tomas Pondeca,USA,MF,22,1.3,2,1,0,1,1,0,3,0.0,3,0,0,0,1,3,0,0,Matches,FC Dallas
Herbert Endeley,USA,MF,22,1.3,1,1,1,0,0,1,1,100.0,0,1,0,1,1,2,3,0,Matches,FC Dallas
Carle-Fred Sainte,HAI,MF,21,0.5,2,2,0,1,1,1,2,50.0,1,5,1,4,2,4,2,0,Matches,FC Dallas
Tarik Scott,USA,FW,19,0.4,0,0,0,0,0,0,0,,0,2,0,2,0,0,0,0,Matches,FC Dallas
Paxton Pomykal,USA,MF,24,0.1,1,0,1,0,0,0,0,,0,0,0,0,0,1,0,0,Matches,FC Dallas
