Player,Nation,POS,Age,90s,Tackles_Tkl,Tackles_TklW,Tackles_Def 3rd,Tackles_Mid 3rd,Tackles_Att 3rd,Challenges_Tkl,Challenges_Att,Challenges_Tkl%,Challenges_Lost,Blocks_Blocks,Blocks_Sh,Blocks_Pass,Unnamed: 17_level_0_Int,Unnamed: 18_level_0_Tkl+Int,Clr,Err,Unnamed: 21_level_0_Matches,Team
Drake Callender,USA,GK,26,21.0,1,1,1,0,0,1,1,100.0,0,0,0,0,1,2,9,1,Matches,Inter Miami
Julian Gressel,USA,MF,30,18.0,20,11,8,10,2,9,24,37.5,15,12,4,8,11,31,9,2,Matches,Inter Miami
Sergio Busquets,ESP,MF,35,19.6,45,27,16,23,6,28,52,53.8,24,32,9,23,15,60,28,2,Matches,Inter Miami
Tomás Avilés,ARG,DF,20,17.0,34,20,26,6,2,13,26,50.0,13,20,12,8,29,63,53,2,Matches,Inter Miami
Robert Taylor,FIN,FW,29,13.8,12,9,5,2,5,3,13,23.1,10,12,0,12,11,23,4,0,Matches,Inter Miami
Jordi Alba,ESP,DF,35,15.6,18,11,8,8,2,8,24,33.3,16,14,5,9,9,27,25,1,Matches,Inter Miami
Marcelo Weigandt,ARG,DF,24,13.4,36,24,24,12,0,24,43,55.8,19,17,6,11,11,47,40,0,Matches,Inter Miami
Luis Suárez,URU,FW,37,12.8,2,1,1,1,0,0,1,0.0,1,2,0,2,2,4,8,0,Matches,Inter Miami
Serhiy Kryvtsov,UKR,DF,33,12.0,8,4,6,2,0,5,14,35.7,9,26,20,6,18,26,51,1,Matches,Inter Miami
Lionel Messi,ARG,FW,37,11.5,12,5,0,5,7,4,5,80.0,1,4,0,4,2,14,0,0,Matches,Inter Miami
Leonardo Campana,ECU,FW,23,10.2,9,7,0,6,3,3,9,33.3,6,9,1,8,1,10,8,0,Matches,Inter Miami
David Ruiz,HON,MF,20,9.5,26,21,14,11,1,13,33,39.4,20,13,3,10,12,38,11,1,Matches,Inter Miami
Diego Gómez,PAR,MF,21,8.9,33,19,10,18,5,16,35,45.7,19,19,1,18,11,44,5,1,Matches,Inter Miami
Nicolás Freire,ARG,DF,30,8.2,9,4,8,1,0,7,11,63.6,4,16,9,7,13,22,41,0,Matches,Inter Miami
Ben Cremaschi,USA,MF,19,8.4,15,12,6,7,2,7,16,43.8,9,9,2,7,13,28,9,0,Matches,Inter Miami
Franco Negri,ARG,DF,29,5.8,14,10,11,1,2,10,15,66.7,5,9,2,7,13,27,18,0,Matches,Inter Miami
Matías Rojas,PAR,FW,28,5.5,11,6,5,5,1,4,8,50.0,4,6,1,5,2,13,1,0,Matches,Inter Miami
Noah Allen,USA,DF,20,5.4,12,8,11,1,0,6,11,54.5,5,3,1,2,4,16,12,0,Matches,Inter Miami
Federico Redondo,ARG,MF,21,4.3,9,7,4,5,0,5,7,71.4,2,6,1,5,1,10,3,0,Matches,Inter Miami
Yannick Bright,ITA,MF,22,5.3,11,6,3,7,1,7,20,35.0,13,10,5,5,17,28,19,0,Matches,Inter Miami
DeAndre Yedlin,USA,DF,30,3.0,6,2,3,3,0,3,7,42.9,4,4,1,3,7,13,11,0,Matches,Inter Miami
Lawson Sunderland,USA,MF,22,2.1,4,3,1,3,0,1,4,25.0,3,6,1,5,3,7,1,0,Matches,Inter Miami
Ryan Sailor,USA,DF,25,3.4,3,2,3,0,0,2,2,100.0,0,2,2,0,4,7,16,1,Matches,Inter Miami
Ian Fray,USA,DF,21,1.5,6,4,4,1,1,2,5,40.0,3,2,1,1,5,11,2,0,Matches,Inter Miami
Leonardo Afonso,BRA,FW,22,2.4,8,6,5,2,1,2,6,33.3,4,2,0,2,5,13,2,0,Matches,Inter Miami
Shanyder Borgelin,HAI,FW,22,1.5,2,2,1,1,0,0,1,0.0,1,0,0,0,0,2,3,0,Matches,Inter Miami
C.J. dos Santos,USA,GK,23,1.0,0,0,0,0,0,0,0,,0,0,0,0,0,0,0,0,Matches,Inter Miami
Jose Casas de Abadal,USA,FW,24,0.3,2,1,0,1,1,0,1,0.0,1,0,0,0,0,2,0,0,Matches,Inter Miami
Jean Mota,BRA,MF,30,0.3,0,0,0,0,0,0,0,,0,0,0,0,0,0,0,0,Matches,Inter Miami
Pavel Bucha,CZE,MF,26,20.7,30,20,9,18,3,18,39,46.2,21,30,9,21,27,57,17,0,Matches,FC Cincinnati
Luciano Acosta,ARG,MF,30,20.1,29,20,10,16,3,14,26,53.8,12,20,0,20,10,39,4,0,Matches,FC Cincinnati
Luca Orellano,ARG,DF,24,18.4,30,17,21,6,3,19,37,51.4,18,17,1,16,5,35,23,2,Matches,FC Cincinnati
Roman Celentano,USA,GK,23,17.0,0,0,0,0,0,0,3,0.0,3,0,0,0,0,0,7,0,Matches,FC Cincinnati
Obinna Nwobodo,NGA,MF,27,15.7,45,33,21,21,3,14,28,50.0,14,21,9,12,33,78,22,0,Matches,FC Cincinnati
Matt Miazga,USA,DF,28,15.7,23,11,19,3,1,12,18,66.7,6,18,13,5,12,35,76,1,Matches,FC Cincinnati
Ian Murphy,USA,DF,24,16.2,27,18,15,12,0,12,20,60.0,8,17,8,9,20,47,52,0,Matches,FC Cincinnati
Yuya Kubo,JPN,FW,30,15.5,40,24,14,17,9,23,34,67.6,11,14,3,11,13,53,16,1,Matches,FC Cincinnati
Miles Robinson,USA,DF,27,15.0,23,17,13,9,1,12,16,75.0,4,19,7,12,18,41,65,0,Matches,FC Cincinnati
DeAndre Yedlin,USA,DF,30,13.4,24,14,12,10,2,13,25,52.0,12,15,4,11,13,37,31,0,Matches,FC Cincinnati
Corey Baird,USA,FW,28,9.0,7,2,6,1,0,3,9,33.3,6,4,0,4,1,8,5,0,Matches,FC Cincinnati
Gerardo Valenzuela,USA,FW,20,7.8,22,15,3,13,6,9,17,52.9,8,11,2,9,4,26,8,0,Matches,FC Cincinnati
Kevin Kelsy,VEN,FW,19,7.4,4,2,1,1,2,1,1,100.0,0,7,0,7,3,7,4,0,Matches,FC Cincinnati
Kipp Keller,USA,DF,23,6.9,8,8,6,2,0,5,6,83.3,1,13,11,2,8,16,29,0,Matches,FC Cincinnati
Nick Hagglund,USA,DF,31,5.1,5,5,4,1,0,4,5,80.0,1,4,2,2,9,14,23,0,Matches,FC Cincinnati
Aaron Boupendza,GAB,FW,27,5.8,4,2,0,3,1,1,7,14.3,6,4,2,2,3,7,6,0,Matches,FC Cincinnati
Sergio Santos Gomes,BRA,FW,29,5.4,12,7,5,3,4,2,10,20.0,8,5,0,5,3,15,5,1,Matches,FC Cincinnati
Alvas Powell,JAM,DF,29,3.2,12,8,5,5,2,7,8,87.5,1,3,2,1,2,14,12,0,Matches,FC Cincinnati
Alec Kann,USA,GK,33,3.0,0,0,0,0,0,0,0,,0,0,0,0,0,0,2,1,Matches,FC Cincinnati
Bret Halsey,USA,DF,24,3.8,8,6,3,3,2,4,6,66.7,2,6,0,6,1,9,5,0,Matches,FC Cincinnati
Yamil Asad,ARG,DF,29,3.0,11,8,5,5,1,6,11,54.5,5,7,2,5,2,13,3,0,Matches,FC Cincinnati
Malik Pinto,USA,MF,21,1.7,10,9,6,4,0,4,7,57.1,3,3,0,3,1,11,1,0,Matches,FC Cincinnati
Evan Louro,USA,GK,28,1.0,0,0,0,0,0,0,0,,0,0,0,0,0,0,0,0,Matches,FC Cincinnati
Isaiah Foster,USA,DF,20,0.0,0,0,0,0,0,0,0,,0,0,0,0,0,0,0,0,Matches,FC Cincinnati
Stiven Jimenez,USA,MF,17,0.0,0,0,0,0,0,0,0,,0,0,0,0,0,0,0,0,Matches,FC Cincinnati
Matt Freese,USA,GK,25,21.0,0,0,0,0,0,0,2,0.0,2,1,0,1,0,0,8,3,Matches,New York City FC
Santiago Rodríguez,URU,MF,24,20.2,25,19,11,8,6,6,26,23.1,20,19,1,18,7,32,4,0,Matches,New York City FC
Birk Risa,NOR,DF,26,18.6,11,7,9,2,0,8,11,72.7,3,17,15,2,16,27,60,3,Matches,New York City FC
Thiago Martins,BRA,DF,29,19.0,12,8,8,4,0,8,13,61.5,5,25,12,13,13,25,86,1,Matches,New York City FC
Kevin O'Toole,USA,DF,25,18.5,36,24,23,7,6,22,34,64.7,12,24,3,21,21,57,48,0,Matches,New York City FC
Hannes Wolf,AUT,FW,25,16.8,30,17,12,13,5,17,41,41.5,24,24,0,24,3,33,4,1,Matches,New York City FC
James Sands,USA,MF,23,17.9,58,43,16,33,9,25,35,71.4,10,31,9,22,31,89,35,1,Matches,New York City FC
Keaton Parks,USA,MF,26,16.6,32,23,6,21,5,18,42,42.9,24,15,3,12,5,37,25,0,Matches,New York City FC
Monsef Bakrar,ALG,FW,23,11.8,14,8,1,4,9,6,11,54.5,5,19,1,18,3,17,8,0,Matches,New York City FC
Mitja Ilenič,SVN,DF,19,10.8,12,7,6,5,1,7,14,50.0,7,7,3,4,13,25,25,0,Matches,New York City FC
Tayvon Gray,JAM,DF,21,10.9,25,14,16,6,3,18,22,81.8,4,13,4,9,24,49,24,0,Matches,New York City FC
Agustin Ojeda,ARG,FW,20,7.8,13,11,4,7,2,6,7,85.7,1,3,0,3,4,17,3,0,Matches,New York City FC
Andrés Perea,USA,MF,23,9.2,26,14,13,9,4,14,27,51.9,13,13,1,12,14,40,17,0,Matches,New York City FC
Alonso Martínez,CRC,FW,25,7.2,2,0,0,2,0,1,4,25.0,3,4,2,2,2,4,3,0,Matches,New York City FC
Julián Fernández,ARG,FW,20,5.7,9,6,3,4,2,2,6,33.3,4,13,0,13,4,13,0,1,Matches,New York City FC
Malachi Jones,SLE,FW,20,5.4,15,10,2,9,4,4,6,66.7,2,8,1,7,3,18,7,0,Matches,New York City FC
Strahinja Tanasijević,SRB,DF,27,5.0,5,4,1,4,0,2,3,66.7,1,7,2,5,4,9,21,0,Matches,New York City FC
Jovan Mijatović,SRB,FW,18,2.4,0,0,0,0,0,0,1,0.0,1,1,0,1,0,0,1,0,Matches,New York City FC
Maximiliano Moralez,ARG,MF,37,2.2,1,0,0,0,1,0,0,,0,1,0,1,4,5,0,0,Matches,New York City FC
Andres Jasson,USA,MF,22,1.7,8,5,6,1,1,3,5,60.0,2,1,0,1,1,9,5,0,Matches,New York City FC
Justin Haak,USA,DF,22,1.0,3,2,1,2,0,2,5,40.0,3,3,1,2,3,6,2,0,Matches,New York City FC
Christian McFarlane, ENG,DF,17,0.2,1,1,0,1,0,1,1,100.0,0,0,0,0,0,1,0,0,Matches,New York City FC
Talles Magno,BRA,MF,22,0.1,1,1,0,1,0,1,1,100.0,0,0,0,0,0,1,0,0,Matches,New York City FC
Diego Rossi,URU,MF,26,17.1,4,0,1,1,2,1,8,12.5,7,7,0,7,3,7,3,0,Matches,Columbus Crew
Patrick Schulte,USA,GK,23,17.0,1,0,1,0,0,1,2,50.0,1,0,0,0,0,1,3,1,Matches,Columbus Crew
Darlington Nagbe,USA,MF,33,15.7,17,8,5,10,2,7,16,43.8,9,9,3,6,2,19,11,0,Matches,Columbus Crew
Malte Amundsen,DEN,DF,26,15.0,27,14,19,7,1,20,29,69.0,9,18,6,12,36,63,40,0,Matches,Columbus Crew
Aidan Morris,USA,MF,22,14.2,51,33,19,27,5,25,35,71.4,10,26,4,22,23,74,9,2,Matches,Columbus Crew
Rudy Camacho,FRA,DF,33,14.0,18,10,13,5,0,13,16,81.3,3,16,7,9,23,41,44,0,Matches,Columbus Crew
Steven Moreira,CPV,DF,29,14.5,15,8,8,5,2,8,18,44.4,10,12,3,9,8,23,29,1,Matches,Columbus Crew
Cucho,COL,FW,25,12.7,17,10,3,5,9,4,8,50.0,4,13,1,12,10,27,4,0,Matches,Columbus Crew
Sean Zawadzki,USA,MF,24,12.6,33,19,15,12,6,15,23,65.2,8,12,3,9,20,53,27,0,Matches,Columbus Crew
Mohamed Farsi,CAN,DF,24,11.6,9,7,2,4,3,5,7,71.4,2,14,1,13,6,15,18,0,Matches,Columbus Crew
Maximilian Arfsten,USA,DF,23,10.5,15,9,8,5,2,8,22,36.4,14,13,1,12,6,21,18,0,Matches,Columbus Crew
Yaw Yeboah,GHA,DF,27,10.4,11,3,6,1,4,8,20,40.0,12,6,0,6,8,19,7,0,Matches,Columbus Crew
Yevhen Cheberko,UKR,DF,26,9.2,15,10,9,5,1,9,16,56.3,7,12,8,4,16,31,25,0,Matches,Columbus Crew
Jacen Russell-Rowe,CAN,FW,21,8.0,8,4,2,3,3,4,7,57.1,3,5,0,5,1,9,0,0,Matches,Columbus Crew
Christian Ramirez,USA,FW,33,7.1,1,1,0,0,1,1,1,100.0,0,1,0,1,0,1,7,0,Matches,Columbus Crew
Alexandru Mățan,ROU,MF,24,6.4,5,4,3,2,0,1,3,33.3,2,2,0,2,1,6,0,0,Matches,Columbus Crew
Marino Hinestroza,COL,MF,21,3.8,6,6,0,4,2,1,4,25.0,3,3,0,3,1,7,0,0,Matches,Columbus Crew
William Sands,USA,DF,23,2.8,6,3,2,3,1,2,4,50.0,2,3,0,3,2,8,3,0,Matches,Columbus Crew
Evan Bush,USA,GK,38,1.4,0,0,0,0,0,0,0,,0,0,0,0,0,0,0,0,Matches,Columbus Crew
Derrick Jones,USA,MF,27,1.7,6,3,2,4,0,5,5,100.0,0,2,0,2,3,9,4,0,Matches,Columbus Crew
Philip Quinton,USA,DF,24,1.0,0,0,0,0,0,0,0,,0,1,1,0,0,0,3,0,Matches,Columbus Crew
Taha Habroune,USA,MF,18,0.8,3,2,0,2,1,2,4,50.0,2,6,1,5,1,4,2,0,Matches,Columbus Crew
Nicholas Hagen,GUA,GK,27,0.6,0,0,0,0,0,0,0,,0,0,0,0,0,0,0,0,Matches,Columbus Crew
Cole Mrowka,USA,MF,18,0.0,0,0,0,0,0,0,0,,0,0,0,0,0,0,0,0,Matches,Columbus Crew
Frankie Amaya,USA,MF,23,17.9,34,24,9,19,6,13,34,38.2,21,19,4,15,24,58,23,0,Matches,New York Red Bulls
Sean Nealis,USA,DF,27,17.7,26,14,18,8,0,18,29,62.1,11,20,12,8,22,48,63,1,Matches,New York Red Bulls
John Tolkin,USA,DF,21,16.6,33,21,18,9,6,13,22,59.1,9,20,3,17,16,49,31,0,Matches,New York Red Bulls
Dante Vanzeir,BEL,FW,26,14.0,11,4,1,3,7,6,10,60.0,4,8,0,8,2,13,5,0,Matches,New York Red Bulls
Dylan Nealis,USA,DF,25,16.2,39,26,21,14,4,23,38,60.5,15,25,2,23,15,54,49,0,Matches,New York Red Bulls
Noah Eile,SWE,DF,21,15.9,16,10,9,7,0,6,10,60.0,4,12,9,3,30,46,64,0,Matches,New York Red Bulls
Daniel Edelman,USA,MF,21,15.8,29,13,5,22,2,11,27,40.7,16,30,8,22,23,52,30,1,Matches,New York Red Bulls
Carlos Coronel,PAR,GK,27,15.0,0,0,0,0,0,0,2,0.0,2,0,0,0,0,0,12,0,Matches,New York Red Bulls
Wikelman Carmona,VEN,MF,21,14.4,45,29,27,12,6,17,33,51.5,16,29,2,27,11,56,13,1,Matches,New York Red Bulls
Lewis Morgan, SCO,FW,27,14.9,13,8,4,3,6,2,8,25.0,6,10,2,8,4,17,7,0,Matches,New York Red Bulls
Emil Forsberg,SWE,MF,32,12.7,10,7,2,4,4,4,12,33.3,8,7,1,6,4,14,4,0,Matches,New York Red Bulls
Elias Manoel,BRA,FW,22,11.3,3,1,0,2,1,2,10,20.0,8,7,0,7,2,5,3,0,Matches,New York Red Bulls
Kyle Duncan,USA,DF,26,9.8,22,18,9,9,4,16,23,69.6,7,13,1,12,14,36,24,0,Matches,New York Red Bulls
Andrés Reyes,COL,DF,24,7.4,10,3,8,2,0,7,16,43.8,9,20,6,14,11,21,25,1,Matches,New York Red Bulls
Peter Stroud,USA,MF,22,6.7,17,11,7,8,2,9,16,56.3,7,10,2,8,5,22,9,0,Matches,New York Red Bulls
Cameron Harper,USA,MF,22,7.0,7,5,3,1,3,5,11,45.5,6,5,1,4,3,10,10,0,Matches,New York Red Bulls
Ryan Meara,USA,GK,33,6.0,0,0,0,0,0,0,0,,0,0,0,0,0,0,4,0,Matches,New York Red Bulls
Dennis Gjengaar,NOR,MF,20,5.8,5,3,1,2,2,2,8,25.0,6,11,0,11,2,7,3,0,Matches,New York Red Bulls
Ronald Donkor,MLI,MF,19,1.5,3,1,0,3,0,1,5,20.0,4,1,0,1,1,4,1,0,Matches,New York Red Bulls
Cory Burke,JAM,FW,32,2.1,4,3,0,2,2,1,3,33.3,2,3,0,3,1,5,3,0,Matches,New York Red Bulls
Julian Hall,USA,FW,16,0.9,2,1,1,0,1,1,1,100.0,0,0,0,0,2,4,0,0,Matches,New York Red Bulls
Mohammed Sofo,GHA,MF,19,0.3,1,1,0,1,0,0,1,0.0,1,1,0,1,0,1,0,0,Matches,New York Red Bulls
Roald Mitchell,USA,FW,21,0.2,0,0,0,0,0,0,0,,0,1,1,0,0,0,1,0,Matches,New York Red Bulls
Aidan O'Connor,USA,DF,22,0.2,2,0,2,0,0,1,1,100.0,0,0,0,0,0,2,0,0,Matches,New York Red Bulls
Serge Ngoma,USA,MF,18,0.2,0,0,0,0,0,0,1,0.0,1,1,0,1,0,0,0,0,Matches,New York Red Bulls
Omar Valencia,PAN,MF,20,0.0,1,1,0,1,0,1,1,100.0,0,0,0,0,0,1,1,0,Matches,New York Red Bulls
Federico Bernardeschi,ITA,DF,30,18.9,16,10,8,3,5,11,18,61.1,7,11,3,8,15,31,11,0,Matches,Toronto FC
Deybi Flores,HON,MF,28,18.0,50,37,24,23,3,21,47,44.7,26,19,7,12,25,75,35,1,Matches,Toronto FC
Nicksoen Gomis,FRA,DF,22,16.9,27,16,15,12,0,17,20,85.0,3,15,7,8,17,44,36,1,Matches,Toronto FC
Kevin Long,IRL,DF,33,16.3,27,10,13,13,1,14,20,70.0,6,27,14,13,11,38,88,2,Matches,Toronto FC
Matthew Longstaff, ENG,MF,24,15.1,34,20,7,20,7,10,20,50.0,10,12,3,9,5,39,16,0,Matches,Toronto FC
Raoul Petretta,ITA,DF,27,13.6,21,14,13,7,1,15,22,68.2,7,23,7,16,18,39,29,0,Matches,Toronto FC
Alonso Coello,ESP,MF,24,13.0,39,22,20,18,1,22,36,61.1,14,18,3,15,18,57,9,1,Matches,Toronto FC
Prince Osei Owusu,GER,FW,27,13.6,19,8,4,9,6,6,11,54.5,5,15,1,14,4,23,18,0,Matches,Toronto FC
Sigurd Rosted,NOR,DF,29,13.7,20,8,10,9,1,12,18,66.7,6,15,6,9,20,40,30,0,Matches,Toronto FC
Jonathan Osorio,CAN,MF,32,13.1,13,11,8,3,2,5,12,41.7,7,12,2,10,6,19,10,0,Matches,Toronto FC
Sean Johnson,USA,GK,35,13.0,0,0,0,0,0,0,0,,0,0,0,0,0,0,8,1,Matches,Toronto FC
Lorenzo Insigne,ITA,MF,33,10.1,9,7,5,2,2,4,9,44.4,5,9,0,9,6,15,0,0,Matches,Toronto FC
Derrick Etienne,HAI,MF,27,9.9,8,8,1,4,3,5,9,55.6,4,11,2,9,5,13,7,0,Matches,Toronto FC
Tyrese Spicer,,DF,,9.4,20,15,9,7,4,4,11,36.4,7,23,2,21,9,29,12,1,Matches,Toronto FC
Luka Gavran,CAN,GK,24,9.0,2,2,2,0,0,1,1,100.0,0,0,0,0,0,2,7,2,Matches,Toronto FC
Jahkeele Marshall-Rutty,CAN,DF,20,9.3,15,12,9,3,3,9,12,75.0,3,10,1,9,5,20,16,0,Matches,Toronto FC
Deandre Kerr,CAN,FW,21,6.1,4,4,0,2,2,2,2,100.0,0,3,0,3,2,6,4,0,Matches,Toronto FC
Shane O'Neill,USA,DF,30,5.9,12,7,7,5,0,6,9,66.7,3,4,1,3,10,22,21,0,Matches,Toronto FC
Kosi Thompson,CAN,MF,21,6.5,15,9,9,4,2,10,14,71.4,4,18,5,13,5,20,16,1,Matches,Toronto FC
Kobe Franklin,CAN,DF,21,4.9,3,2,1,1,1,2,6,33.3,4,5,1,4,2,5,17,0,Matches,Toronto FC
Aimé Mabika,ZAM,DF,25,3.6,2,1,0,2,0,0,1,0.0,1,5,4,1,4,6,12,1,Matches,Toronto FC
Richie Laryea,CAN,DF,29,0.9,4,3,4,0,0,1,1,100.0,0,0,0,0,1,5,2,0,Matches,Toronto FC
Ayo Akinola,CAN,FW,24,1.0,0,0,0,0,0,0,1,0.0,1,0,0,0,1,1,0,0,Matches,Toronto FC
Cassius Mailula,RSA,MF,23,0.2,0,0,0,0,0,0,0,,0,1,0,1,1,1,0,0,Matches,Toronto FC
Charles Sharp,USA,FW,23,0.2,0,0,0,0,0,0,0,,0,0,0,0,1,1,1,0,Matches,Toronto FC
Kristijan Kahlina,CRO,GK,31,22.0,0,0,0,0,0,0,0,,0,0,0,0,1,1,16,2,Matches,Charlotte FC
Andrew Privett,USA,DF,23,22.0,22,18,17,4,1,9,16,56.3,7,32,19,13,10,32,92,3,Matches,Charlotte FC
Ashley Westwood, ENG,MF,34,21.0,13,5,5,6,2,5,10,50.0,5,12,6,6,14,27,28,1,Matches,Charlotte FC
Kerwin Vargas,COL,FW,22,19.4,19,11,6,9,4,13,17,76.5,4,18,1,17,6,25,26,0,Matches,Charlotte FC
Adilson Malanda,FRA,DF,22,20.0,23,15,16,5,2,16,23,69.6,7,20,15,5,21,44,88,1,Matches,Charlotte FC
Nathan Byrne, ENG,DF,32,19.0,18,9,10,5,3,9,12,75.0,3,9,4,5,14,32,51,1,Matches,Charlotte FC
Jere Uronen,FIN,DF,29,16.8,30,15,15,11,4,22,36,61.1,14,27,8,19,24,54,42,0,Matches,Charlotte FC
Patrick Agyemang,USA,FW,23,15.7,13,7,0,3,10,6,12,50.0,6,6,1,5,0,13,11,0,Matches,Charlotte FC
Djibril Diani,FRA,MF,26,13.9,34,21,10,17,7,20,34,58.8,14,30,4,26,13,47,11,0,Matches,Charlotte FC
Liel Abada,ISR,FW,22,10.1,9,7,2,3,4,5,13,38.5,8,5,0,5,4,13,3,0,Matches,Charlotte FC
Brecht Dejaegere,BEL,MF,33,9.6,22,11,3,13,6,8,23,34.8,15,14,0,14,10,32,6,0,Matches,Charlotte FC
Brandt Bronico,USA,MF,29,8.9,10,6,5,2,3,3,8,37.5,5,14,4,10,6,16,3,0,Matches,Charlotte FC
Iuri Tavares,CPV,FW,23,7.1,16,9,3,8,5,7,14,50.0,7,16,2,14,4,20,15,0,Matches,Charlotte FC
Júnior Urso,BRA,MF,35,6.6,15,9,2,11,2,6,16,37.5,10,5,1,4,10,25,14,0,Matches,Charlotte FC
Enzo Copetti,ARG,FW,28,5.5,1,0,0,1,0,0,3,0.0,3,2,1,1,2,3,3,0,Matches,Charlotte FC
Nikola Petković,SRB,MF,21,5.3,9,5,2,4,3,4,8,50.0,4,6,1,5,4,13,1,0,Matches,Charlotte FC
João Pedro,BRA,DF,21,4.9,9,7,5,2,2,4,12,33.3,8,3,0,3,5,14,13,0,Matches,Charlotte FC
Scott Arfield,CAN,MF,35,4.2,2,1,1,1,0,1,3,33.3,2,5,0,5,1,3,2,0,Matches,Charlotte FC
Jaylin Lindsey,USA,DF,24,3.3,13,6,9,4,0,6,9,66.7,3,3,1,2,2,15,6,0,Matches,Charlotte FC
Bill Tuiloma,NZL,DF,29,2.0,1,1,0,1,0,1,1,100.0,0,2,1,1,1,2,8,0,Matches,Charlotte FC
Ben Bender,USA,MF,23,1.7,1,0,1,0,0,0,0,,0,2,0,2,0,1,1,0,Matches,Charlotte FC
Tyger Smalls,,FW,,2.1,7,5,3,2,2,1,6,16.7,5,7,1,6,2,9,3,0,Matches,Charlotte FC
Nimfasha Berchimas,USA,FW,16,0.3,1,0,1,0,0,1,1,100.0,0,2,0,2,0,1,0,0,Matches,Charlotte FC
Kai Wagner,GER,DF,27,19.5,36,22,26,8,2,19,32,59.4,13,17,7,10,24,60,39,0,Matches,Philadelphia Union
Nathan Harriel,USA,DF,23,18.9,49,26,16,24,9,20,31,64.5,11,37,10,27,21,70,61,1,Matches,Philadelphia Union
Jakob Glesnes,NOR,DF,30,18.4,30,11,23,7,0,18,34,52.9,16,24,14,10,32,62,75,1,Matches,Philadelphia Union
Quinn Sullivan,USA,MF,20,18.1,24,12,6,11,7,8,24,33.3,16,18,1,17,5,29,13,0,Matches,Philadelphia Union
Jack McGlynn,USA,MF,20,18.2,39,27,16,17,6,19,33,57.6,14,19,2,17,11,50,16,0,Matches,Philadelphia Union
Jack Elliott, ENG,DF,28,15.3,27,17,18,9,0,15,21,71.4,6,26,17,9,19,46,61,0,Matches,Philadelphia Union
Dániel Gazdag,HUN,MF,28,15.8,16,8,5,8,3,3,13,23.1,10,7,1,6,6,22,5,0,Matches,Philadelphia Union
Oliver Semmle,GER,GK,26,15.6,1,0,1,0,0,1,1,100.0,0,0,0,0,0,1,7,0,Matches,Philadelphia Union
Mikael Uhre,DEN,FW,29,13.3,21,12,3,9,9,10,19,52.6,9,8,1,7,2,23,11,0,Matches,Philadelphia Union
Julián Carranza,ARG,FW,24,11.9,16,14,5,4,7,5,10,50.0,5,11,1,10,10,26,19,0,Matches,Philadelphia Union
Leon Flach,USA,MF,23,9.9,27,14,15,9,3,14,24,58.3,10,21,1,20,22,49,10,0,Matches,Philadelphia Union
José Andrés Martínez,VEN,MF,29,9.3,20,11,8,9,3,10,18,55.6,8,8,4,4,11,31,7,1,Matches,Philadelphia Union
Damion Lowe,JAM,DF,31,8.0,12,12,4,6,2,8,12,66.7,4,17,8,9,15,27,41,0,Matches,Philadelphia Union
Alejandro Bedoya,USA,MF,37,10.4,21,12,7,10,4,9,14,64.3,5,11,0,11,13,34,11,0,Matches,Philadelphia Union
Jesús Daniel Bueno,VEN,MF,25,5.7,17,13,7,8,2,9,21,42.9,12,7,0,7,9,26,1,0,Matches,Philadelphia Union
Olivier Mbaizo,CMR,DF,26,5.6,8,8,2,3,3,5,9,55.6,4,5,2,3,6,14,13,0,Matches,Philadelphia Union
Andre Blake,JAM,GK,33,3.4,0,0,0,0,0,0,0,,0,0,0,0,0,0,1,1,Matches,Philadelphia Union
Jeremy Rafanello,USA,MF,24,3.3,3,2,0,2,1,1,6,16.7,5,3,0,3,0,3,4,0,Matches,Philadelphia Union
Christopher Donovan,USA,FW,23,3.5,8,5,2,3,3,4,6,66.7,2,6,0,6,2,10,1,0,Matches,Philadelphia Union
Thai Baribo,ISR,FW,26,3.1,8,5,0,5,3,2,5,40.0,3,3,0,3,1,9,1,0,Matches,Philadelphia Union
Andrew Rick,USA,GK,18,2.0,0,0,0,0,0,0,0,,0,0,0,0,0,0,3,0,Matches,Philadelphia Union
Markus Anderson,USA,MF,20,1.1,0,0,0,0,0,0,2,0.0,2,2,0,2,1,1,2,0,Matches,Philadelphia Union
Christopher Olney,USA,MF,17,0.2,0,0,0,0,0,0,1,0.0,1,0,0,0,1,1,0,0,Matches,Philadelphia Union
Lucas Bartlett,USA,DF,26,21.6,25,16,12,13,0,12,20,60.0,8,30,16,14,23,48,77,1,Matches,DC United
Mateusz Klich,POL,MF,34,20.4,36,22,14,12,10,19,45,42.2,26,19,4,15,13,49,2,0,Matches,DC United
Jared Stroud,USA,FW,27,18.3,33,19,17,12,4,20,45,44.4,25,19,1,18,10,43,10,0,Matches,DC United
Aaron Herrera,GUA,DF,27,19.0,43,22,18,15,10,24,39,61.5,15,36,13,23,23,66,46,0,Matches,DC United
Alex Bono,USA,GK,30,18.0,2,0,2,0,0,2,2,100.0,0,0,0,0,0,2,10,1,Matches,DC United
Christian Benteke,BEL,FW,33,17.2,3,3,0,2,1,1,5,20.0,4,7,2,5,0,3,19,0,Matches,DC United
Cristián Dajome,COL,FW,30,15.7,27,17,9,15,3,14,31,45.2,17,22,3,19,12,39,17,0,Matches,DC United
Matti Peltola,FIN,MF,22,16.5,53,36,19,25,9,27,44,61.4,17,23,7,16,23,76,19,3,Matches,DC United
Christopher McVey,SWE,DF,27,14.6,22,13,11,9,2,11,21,52.4,10,23,14,9,26,48,41,0,Matches,DC United
Theodore Ku-Dipietro,USA,MF,22,13.1,18,13,5,10,3,2,13,15.4,11,10,0,10,9,27,2,0,Matches,DC United
Jackson Hopkins,USA,MF,20,10.4,19,13,6,12,1,10,24,41.7,14,10,0,10,2,21,19,0,Matches,DC United
Pedro Santos,POR,DF,36,10.8,38,25,21,12,5,20,36,55.6,16,12,1,11,19,57,32,0,Matches,DC United
Gabriel Pirani,BRA,MF,22,8.6,14,8,4,7,3,5,10,50.0,5,6,0,6,3,17,2,0,Matches,DC United
Jacob Murrell,USA,FW,20,7.8,2,2,1,0,1,1,10,10.0,9,6,1,5,2,4,11,0,Matches,DC United
Conner Antley,USA,DF,29,4.8,16,10,10,5,1,8,13,61.5,5,8,3,5,6,22,17,0,Matches,DC United
Tyler Miller,USA,GK,31,4.0,0,0,0,0,0,0,0,,0,0,0,0,0,0,4,1,Matches,DC United
Garrison Tubbs,USA,DF,22,3.9,13,5,6,6,1,8,8,100.0,0,5,2,3,3,16,11,0,Matches,DC United
Steve Birnbaum,USA,DF,33,3.8,2,1,1,1,0,0,3,0.0,3,4,4,0,4,6,13,0,Matches,DC United
Martín Rodríguez,CHI,MF,29,5.1,15,11,4,9,2,8,13,61.5,5,9,1,8,10,25,2,0,Matches,DC United
Matai Akinmboni,USA,DF,17,4.0,8,7,5,3,0,4,5,80.0,1,7,4,3,8,16,13,0,Matches,DC United
Kristian Fletcher,USA,FW,18,2.7,3,2,2,1,0,3,8,37.5,5,4,0,4,2,5,3,0,Matches,DC United
Jeremy Garay,SLV,FW,21,0.0,0,0,0,0,0,0,0,,0,0,0,0,0,0,0,0,Matches,DC United
Mohanad Jeahze,IRQ,MF,27,0.0,0,0,0,0,0,0,0,,0,0,0,0,0,0,0,0,Matches,DC United
Iván Angulo,COL,MF,25,19.1,26,16,10,14,2,7,22,31.8,15,18,1,17,13,39,9,0,Matches,Orlando City
Dagur Dan Þórhallsson,ISL,DF,24,17.0,36,24,21,6,9,18,31,58.1,13,12,6,6,11,47,34,0,Matches,Orlando City
Facundo Torres,URU,FW,24,17.5,18,10,8,3,7,11,23,47.8,12,13,1,12,5,23,8,0,Matches,Orlando City
Robin Jansson,SWE,DF,32,16.7,17,9,13,4,0,9,18,50.0,9,24,15,9,16,33,51,0,Matches,Orlando City
Pedro Gallese,PER,GK,34,16.0,0,0,0,0,0,0,1,0.0,1,0,0,0,0,0,5,3,Matches,Orlando City
César Araujo,URU,MF,23,15.6,43,25,19,16,8,25,53,47.2,28,23,6,17,15,58,12,0,Matches,Orlando City
Duncan McGuire,USA,FW,23,14.1,7,4,1,5,1,2,15,13.3,13,8,1,7,3,10,14,0,Matches,Orlando City
Nicolás Lodeiro,URU,MF,35,15.7,28,15,13,11,4,17,42,40.5,25,22,2,20,11,39,9,0,Matches,Orlando City
Rodrigo Schlegel,ARG,DF,27,14.1,28,18,17,8,3,18,26,69.2,8,21,5,16,21,49,50,1,Matches,Orlando City
Luis Muriel,COL,FW,33,13.7,20,15,5,3,12,11,21,52.4,10,5,0,5,2,22,5,0,Matches,Orlando City
Wilder Cartagena,PER,DF,29,12.6,28,17,13,13,2,15,27,55.6,12,19,6,13,10,38,33,0,Matches,Orlando City
Rafael Santos,BRA,DF,26,12.5,14,5,5,6,3,7,23,30.4,16,9,0,9,13,27,20,1,Matches,Orlando City
Martín Ojeda,ARG,MF,25,12.2,14,8,6,3,5,3,10,30.0,7,13,0,13,5,19,5,0,Matches,Orlando City
David Brekalo,SVN,DF,25,10.7,14,1,8,6,0,9,13,69.2,4,9,2,7,15,29,38,0,Matches,Orlando City
Kyle Smith,USA,DF,32,7.0,13,4,8,5,0,6,13,46.2,7,12,3,9,4,17,25,0,Matches,Orlando City
Mason Stajduhar,USA,GK,26,4.3,0,0,0,0,0,0,1,0.0,1,0,0,0,0,0,1,0,Matches,Orlando City
Felipe,BRA,MF,33,2.9,8,7,5,3,0,6,11,54.5,5,1,0,1,5,13,5,1,Matches,Orlando City
Jack Lynn,USA,FW,24,2.8,2,2,1,0,1,1,5,20.0,4,2,1,1,0,2,2,0,Matches,Orlando City
Ramiro Enrique,ARG,FW,23,2.7,0,0,0,0,0,0,4,0.0,4,2,0,2,0,0,5,0,Matches,Orlando City
Jeorgio Kocevski,USA,MF,21,1.0,2,2,2,0,0,2,4,50.0,2,0,0,0,0,2,4,0,Matches,Orlando City
Michael Halliday,USA,DF,21,1.0,5,3,3,1,1,2,4,50.0,2,3,0,3,1,6,1,0,Matches,Orlando City
Javier Otero,VEN,GK,21,0.7,0,0,0,0,0,0,0,,0,0,0,0,0,0,0,0,Matches,Orlando City
Shakur Mohammed,GHA,MF,20,0.1,0,0,0,0,0,0,0,,0,0,0,0,0,0,0,0,Matches,Orlando City
Alexander Freeman,USA,MF,19,0.0,0,0,0,0,0,0,0,,0,0,0,0,0,0,0,0,Matches,Orlando City
Yutaro Tsukada,JPN,FW,22,0.0,0,0,0,0,0,0,0,,0,0,0,0,0,0,0,0,Matches,Orlando City
Jack Maher,USA,DF,24,19.0,21,12,17,4,0,15,22,68.2,7,28,18,10,26,47,65,0,Matches,Nashville SC
Hany Mukhtar,GER,MF,29,17.9,14,6,3,9,2,3,13,23.1,10,18,0,18,2,16,1,1,Matches,Nashville SC
Dru Yearwood, ENG,MF,24,15.0,36,24,20,11,5,17,41,41.5,24,28,2,26,18,54,15,0,Matches,Nashville SC
Joe Willis,USA,GK,35,17.2,0,0,0,0,0,0,0,,0,0,0,0,1,1,6,0,Matches,Nashville SC
Sam Surridge, ENG,FW,25,15.5,11,6,6,3,2,4,5,80.0,1,8,1,7,1,12,16,0,Matches,Nashville SC
Alex Muyl,USA,DF,28,15.4,27,19,12,11,4,8,24,33.3,16,19,2,17,11,38,14,0,Matches,Nashville SC
Daniel Lovitz,USA,DF,32,14.5,25,20,20,5,0,19,32,59.4,13,10,4,6,14,39,32,1,Matches,Nashville SC
Sean Davis,USA,MF,31,11.7,15,10,10,4,1,4,11,36.4,7,17,5,12,16,31,15,0,Matches,Nashville SC
Josh Bauer,USA,DF,25,13.1,29,20,22,5,2,14,22,63.6,8,17,11,6,14,43,39,0,Matches,Nashville SC
Walker Zimmerman,USA,DF,31,11.6,17,8,10,5,2,9,15,60.0,6,14,10,4,22,39,53,0,Matches,Nashville SC
Tyler Boyd,USA,FW,29,11.3,13,11,4,6,3,9,19,47.4,10,10,1,9,5,18,6,0,Matches,Nashville SC
Aníbal Godoy,PAN,MF,34,10.6,24,15,9,15,0,12,21,57.1,9,10,3,7,25,49,4,1,Matches,Nashville SC
Jacob Shaffelburg,CAN,DF,24,10.0,10,6,2,7,1,3,12,25.0,9,19,1,18,6,16,8,0,Matches,Nashville SC
Shaquell Moore,USA,DF,27,8.0,20,15,13,7,0,14,22,63.6,8,5,3,2,2,22,21,0,Matches,Nashville SC
Brian Anunga,CMR,MF,27,8.6,28,14,14,11,3,12,19,63.2,7,14,4,10,14,42,7,0,Matches,Nashville SC
Teal Bunbury,USA,FW,34,7.5,2,0,1,1,0,1,6,16.7,5,3,1,2,0,2,5,0,Matches,Nashville SC
Taylor Washington,USA,DF,30,5.4,7,6,3,2,2,6,10,60.0,4,5,2,3,4,11,16,0,Matches,Nashville SC
Lukas MacNaughton,CAN,DF,29,4.6,6,4,6,0,0,2,5,40.0,3,5,4,1,4,10,24,0,Matches,Nashville SC
Brent Kallman,USA,DF,33,4.6,5,2,3,2,0,3,5,60.0,2,10,6,4,9,14,26,0,Matches,Nashville SC
Elliot Panicco,USA,GK,27,3.8,0,0,0,0,0,0,0,,0,0,0,0,0,0,0,1,Matches,Nashville SC
Amar Sejdic,USA,MF,27,2.5,7,4,3,4,0,4,7,57.1,3,2,1,1,4,11,2,1,Matches,Nashville SC
McKinze Gaines,USA,MF,26,1.4,1,1,0,1,0,0,2,0.0,2,0,0,0,0,1,0,0,Matches,Nashville SC
Forster Ajago,GHA,FW,22,1.3,1,1,0,1,0,0,0,,0,3,0,3,1,2,0,0,Matches,Nashville SC
Randall Leal,CRC,MF,27,0.1,0,0,0,0,0,0,0,,0,0,0,0,0,0,0,0,Matches,Nashville SC
Joseph Skinner,USA,FW,21,0.0,1,0,0,1,0,0,1,0.0,1,1,0,1,0,1,0,0,Matches,Nashville SC
Brooks Lennon,USA,DF,26,21.0,38,23,19,14,5,23,34,67.6,11,19,8,11,21,59,61,0,Matches,Atlanta United
Caleb Wiley,USA,DF,19,19.9,30,22,23,6,1,20,35,57.1,15,30,9,21,24,54,57,0,Matches,Atlanta United
Tristan Muyumba,,MF,27,18.2,59,42,27,27,5,30,48,62.5,18,17,5,12,15,74,17,0,Matches,Atlanta United
Brad Guzan,USA,GK,39,18.7,0,0,0,0,0,0,0,,0,0,0,0,1,1,10,1,Matches,Atlanta United
Thiago Almada,ARG,MF,23,15.5,18,9,9,5,4,7,20,35.0,13,5,0,5,1,19,5,1,Matches,Atlanta United
Saba Lobzhanidze,GEO,FW,29,14.8,13,11,5,4,4,6,15,40.0,9,18,4,14,4,17,3,0,Matches,Atlanta United
Bartosz Slisz,POL,MF,25,13.9,29,14,14,14,1,12,26,46.2,14,19,9,10,21,50,19,1,Matches,Atlanta United
Noah Cobb,USA,DF,18,12.5,17,13,11,6,0,13,18,72.2,5,21,14,7,7,24,53,0,Matches,Atlanta United
Derrick Williams,IRL,DF,31,12.5,15,8,7,8,0,7,14,50.0,7,21,16,5,13,28,56,2,Matches,Atlanta United
Xande Silva,POR,FW,27,10.8,19,15,5,7,7,10,18,55.6,8,11,0,11,3,22,7,0,Matches,Atlanta United
Luis Abram,PER,DF,28,10.5,8,5,4,1,3,3,8,37.5,5,8,6,2,7,15,44,1,Matches,Atlanta United
Stian Rode Gregersen,NOR,DF,29,9.1,22,18,21,1,0,11,16,68.8,5,22,14,8,10,32,43,0,Matches,Atlanta United
Daniel Armando Ríos,MEX,FW,29,8.1,8,6,2,5,1,3,8,37.5,5,7,2,5,0,8,9,0,Matches,Atlanta United
Giorgos Giakoumakis,GRE,FW,29,8.0,9,7,0,7,2,6,8,75.0,2,6,1,5,3,12,10,0,Matches,Atlanta United
Jamal Thiaré,SEN,FW,31,6.8,3,3,0,3,0,1,5,20.0,4,3,1,2,0,3,8,0,Matches,Atlanta United
Dax McCarty,USA,MF,37,6.3,20,10,11,8,1,12,16,75.0,4,2,0,2,10,30,6,0,Matches,Atlanta United
Ajani Fortune,TRI,MF,21,5.4,10,6,3,5,2,5,10,50.0,5,3,2,1,9,19,7,0,Matches,Atlanta United
Edwin Mosquera,COL,FW,23,4.5,8,6,3,4,1,2,7,28.6,5,2,0,2,4,12,1,1,Matches,Atlanta United
Tyler Wolff,USA,FW,21,3.4,10,8,4,4,2,6,14,42.9,8,9,0,9,4,14,2,0,Matches,Atlanta United
Efrain Morales,BOL,DF,20,2.7,3,1,2,1,0,2,3,66.7,1,2,2,0,3,6,15,0,Matches,Atlanta United
Ronald Hernández,VEN,DF,26,2.5,3,1,3,0,0,3,4,75.0,1,2,1,1,3,6,5,0,Matches,Atlanta United
Josh Cohen,USA,GK,31,2.3,0,0,0,0,0,0,0,,0,0,0,0,0,0,0,0,Matches,Atlanta United
Nicolas Firmino,USA,FW,23,1.8,1,1,0,1,0,1,1,100.0,0,2,0,2,1,2,0,0,Matches,Atlanta United
Luke Brennan,USA,FW,19,0.9,0,0,0,0,0,0,1,0.0,1,2,0,2,0,0,0,0,Matches,Atlanta United
Derrick Etienne,HAI,FW,27,0.3,1,1,1,0,0,1,1,100.0,0,0,0,0,2,3,0,0,Matches,Atlanta United
Ruan,BRA,DF,29,19.2,18,14,10,5,3,4,16,25.0,12,16,3,13,10,28,31,1,Matches,CF Montréal
Jonathan Sirois,CAN,GK,23,20.0,2,1,2,0,0,2,2,100.0,0,0,0,0,0,2,16,3,Matches,CF Montréal
Bryce Duke,USA,MF,23,15.6,25,18,8,15,2,10,23,43.5,13,20,1,19,13,38,12,1,Matches,CF Montréal
Joel Waterman,CAN,DF,28,15.6,16,10,11,3,2,10,13,76.9,3,27,21,6,30,46,69,0,Matches,CF Montréal
Ariel Lassiter,CRC,DF,29,14.4,9,5,7,2,0,4,12,33.3,8,6,1,5,3,12,15,0,Matches,CF Montréal
Mathieu Choiniere,CAN,MF,25,14.6,29,19,12,13,4,13,26,50.0,13,18,4,14,7,36,18,1,Matches,CF Montréal
Samuel Piette,CAN,MF,29,14.1,31,22,11,15,5,20,36,55.6,16,20,6,14,16,47,16,0,Matches,CF Montréal
George Campbell,USA,DF,23,13.7,17,15,12,4,1,11,16,68.8,5,22,10,12,21,38,49,3,Matches,CF Montréal
Gabriele Corbo,ITA,DF,24,13.9,13,8,6,6,1,8,14,57.1,6,21,16,5,10,23,66,0,Matches,CF Montréal
Fernando Álvarez,COL,DF,20,12.7,19,13,12,7,0,14,17,82.4,3,16,8,8,16,35,49,0,Matches,CF Montréal
Joaquin Sosa,URU,DF,22,10.3,29,19,15,11,3,20,28,71.4,8,14,4,10,15,44,33,0,Matches,CF Montréal
Sunusi Ibrahim,NGA,FW,21,9.4,4,2,0,3,1,1,5,20.0,4,5,2,3,4,8,18,0,Matches,CF Montréal
Raheem Edwards,CAN,DF,28,8.2,25,18,15,4,6,10,18,55.6,8,11,0,11,13,38,14,0,Matches,CF Montréal
Nathan-Dylan Saliba,CAN,MF,19,7.3,21,12,9,11,1,11,19,57.9,8,9,4,5,4,25,19,0,Matches,CF Montréal
Jules-Anthony Vilsaint,CAN,MF,21,6.3,4,0,0,4,0,2,4,50.0,2,5,1,4,1,5,4,0,Matches,CF Montréal
Matías Cóccaro,URU,FW,26,6.1,3,1,1,2,0,2,3,66.7,1,13,3,10,3,6,6,0,Matches,CF Montréal
Dominik Yankov,BUL,MF,23,6.8,10,3,3,4,3,4,13,30.8,9,8,0,8,2,12,2,0,Matches,CF Montréal
Mason Toye,USA,FW,25,4.5,0,0,0,0,0,0,3,0.0,3,3,0,3,2,2,4,0,Matches,CF Montréal
Josef Martínez,VEN,FW,31,6.4,2,1,2,0,0,1,3,33.3,2,3,1,2,1,3,5,0,Matches,CF Montréal
Kwadwo Opoku,GHA,MF,22,2.5,0,0,0,0,0,0,4,0.0,4,0,0,0,1,1,1,0,Matches,CF Montréal
Victor Wanyama,KEN,MF,33,3.1,5,5,1,4,0,3,10,30.0,7,4,2,2,5,10,7,0,Matches,CF Montréal
Rida Zouhir,CAN,MF,20,2.0,5,3,1,2,2,2,3,66.7,1,2,0,2,2,7,0,0,Matches,CF Montréal
Sebastian Breza,CAN,GK,26,1.0,0,0,0,0,0,0,0,,0,0,0,0,0,0,1,0,Matches,CF Montréal
Lassi Lappalainen,FIN,DF,25,2.1,11,5,9,2,0,8,10,80.0,2,9,2,7,3,14,5,0,Matches,CF Montréal
Alessandro Biello,CAN,MF,18,0.2,1,1,0,1,0,1,1,100.0,0,0,0,0,1,2,0,0,Matches,CF Montréal
Ousman jabang,USA,DF,23,0.0,2,2,2,0,0,1,1,100.0,0,1,0,1,0,2,0,0,Matches,CF Montréal
Hugo Cuypers,BEL,FW,27,19.4,22,16,3,13,6,6,33,18.2,27,30,2,28,6,28,20,0,Matches,Chicago Fire
Christopher Brady,USA,GK,20,20.0,0,0,0,0,0,0,1,0.0,1,0,0,0,0,0,14,3,Matches,Chicago Fire
Allan Arigoni,SUI,DF,25,17.4,33,24,16,11,6,19,30,63.3,11,26,5,21,14,47,35,0,Matches,Chicago Fire
Rafael Czichos,GER,DF,34,17.8,37,23,28,8,1,25,35,71.4,10,31,14,17,13,50,63,3,Matches,Chicago Fire
Fabian Herbers,GER,MF,30,17.6,46,29,11,28,7,14,38,36.8,24,23,5,18,25,71,13,1,Matches,Chicago Fire
Kellyn Acosta,USA,MF,28,16.3,27,19,10,15,2,12,29,41.4,17,13,1,12,25,52,7,1,Matches,Chicago Fire
Brian Gutiérrez,USA,MF,21,16.3,34,11,9,21,4,15,31,48.4,16,13,0,13,14,48,7,0,Matches,Chicago Fire
Maren Haile-Selassie,SUI,FW,25,12.9,6,5,3,2,1,3,15,20.0,12,7,1,6,6,12,4,0,Matches,Chicago Fire
Carlos Terán,COL,DF,23,11.1,26,19,15,10,1,14,16,87.5,2,16,9,7,22,48,35,1,Matches,Chicago Fire
Mauricio Pineda,USA,DF,26,10.9,12,7,9,3,0,8,16,50.0,8,15,5,10,6,18,25,1,Matches,Chicago Fire
Xherdan Shaqiri,SUI,MF,32,8.2,3,1,1,2,0,2,6,33.3,4,2,0,2,1,4,1,0,Matches,Chicago Fire
Arnaud Souquet,FRA,DF,32,9.4,18,13,14,4,0,8,16,50.0,8,13,2,11,11,29,22,0,Matches,Chicago Fire
Jonathan Dean,USA,DF,27,8.3,15,9,7,7,1,6,13,46.2,7,11,4,7,9,24,26,0,Matches,Chicago Fire
Chris Mueller,USA,FW,27,8.2,10,8,5,3,2,7,16,43.8,9,8,0,8,7,17,7,0,Matches,Chicago Fire
Andrew Gutman,USA,DF,27,5.7,13,8,6,6,1,5,9,55.6,4,5,2,3,7,20,11,1,Matches,Chicago Fire
Gastón Giménez,PAR,MF,32,7.3,22,16,11,9,2,7,13,53.8,6,11,4,7,20,42,13,0,Matches,Chicago Fire
Tobias Salquist,DEN,DF,29,5.0,3,2,2,1,0,3,4,75.0,1,5,5,0,5,8,32,0,Matches,Chicago Fire
Federico Navarro,ARG,MF,24,4.8,20,13,11,7,2,8,11,72.7,3,4,3,1,11,31,12,1,Matches,Chicago Fire
Georgios Koutsias,GRE,FW,20,4.8,9,6,2,5,2,3,9,33.3,6,1,0,1,1,10,2,0,Matches,Chicago Fire
Tom Barlow,USA,FW,28,4.3,4,3,0,3,1,3,8,37.5,5,4,1,3,3,7,5,0,Matches,Chicago Fire
Chase Gasper,USA,DF,28,2.7,2,1,2,0,0,2,2,100.0,0,3,0,3,7,9,14,0,Matches,Chicago Fire
Wyatt Omsberg,USA,DF,28,1.2,1,0,1,0,0,0,0,,0,3,3,0,3,4,5,0,Matches,Chicago Fire
Spencer Richey,USA,GK,32,1.0,0,0,0,0,0,0,0,,0,0,0,0,0,0,1,1,Matches,Chicago Fire
Omari Glasgow,GUY,MF,20,0.4,1,1,0,1,0,1,1,100.0,0,2,1,1,0,1,0,0,Matches,Chicago Fire
Javier Casas,USA,MF,21,0.0,0,0,0,0,0,0,0,,0,0,0,0,0,0,0,0,Matches,Chicago Fire
Carles Gil,ESP,MF,31,17.0,8,5,2,5,1,2,12,16.7,10,8,0,8,4,12,3,0,Matches,New England Revolution
Matt Polster,USA,MF,31,16.3,27,15,12,14,1,11,23,47.8,12,14,8,6,24,51,17,0,Matches,New England Revolution
Nick Lima,USA,DF,29,16.0,22,16,15,6,1,17,31,54.8,14,15,5,10,15,37,40,0,Matches,New England Revolution
Giacomo Vrioni,ALB,FW,25,15.7,9,7,2,3,4,3,7,42.9,4,6,0,6,1,10,2,0,Matches,New England Revolution
DeJuan Jones,USA,DF,27,13.7,26,20,16,8,2,12,24,50.0,12,23,6,17,18,44,40,0,Matches,New England Revolution
Henry Kessler,USA,DF,26,13.0,14,11,12,2,0,6,10,60.0,4,23,16,7,10,24,50,0,Matches,New England Revolution
Esmir Bajraktarevic,USA,FW,19,12.4,23,14,7,12,4,5,19,26.3,14,11,0,11,3,26,5,0,Matches,New England Revolution
David Romney,USA,DF,31,11.6,14,3,8,6,0,7,12,58.3,5,24,13,11,5,19,76,0,Matches,New England Revolution
Xavier Arreaga,ECU,DF,29,10.9,28,17,21,7,0,20,24,83.3,4,15,4,11,17,45,59,0,Matches,New England Revolution
Tomás Chancalay,ARG,FW,25,10.3,10,4,3,5,2,4,20,20.0,16,10,0,10,1,11,2,1,Matches,New England Revolution
Aljaž Ivačič,SVN,GK,30,10.0,0,0,0,0,0,0,0,,0,0,0,0,0,0,6,0,Matches,New England Revolution
Ian Harkes,USA,MF,29,9.7,17,12,8,7,2,10,14,71.4,4,10,3,7,12,29,11,0,Matches,New England Revolution
Mark-Anthony Kaye,CAN,MF,29,9.3,34,22,16,16,2,17,32,53.1,15,22,4,18,9,43,11,1,Matches,New England Revolution
Henrich Ravas,SVK,GK,26,8.0,0,0,0,0,0,0,1,0.0,1,1,0,1,0,0,1,2,Matches,New England Revolution
Dylan Borrero,COL,FW,22,5.6,3,3,1,0,2,1,4,25.0,3,4,0,4,8,11,4,0,Matches,New England Revolution
Noel Buck, ENG,MF,19,5.0,10,4,4,5,1,4,5,80.0,1,7,3,4,3,13,4,0,Matches,New England Revolution
Nacho Gil,ESP,FW,28,5.2,9,5,5,2,2,2,7,28.6,5,5,1,4,6,15,3,0,Matches,New England Revolution
Andrew Farrell,USA,DF,32,5.1,7,6,6,1,0,5,7,71.4,2,6,5,1,3,10,11,0,Matches,New England Revolution
Emmanuel Boateng,GHA,FW,30,4.2,7,3,2,3,2,1,2,50.0,1,8,1,7,4,11,1,0,Matches,New England Revolution
Ryan Spaulding,USA,DF,25,3.8,12,5,5,4,3,5,6,83.3,1,8,2,6,5,17,11,0,Matches,New England Revolution
Jonathan Mensah,GHA,DF,33,1.9,2,2,2,0,0,2,2,100.0,0,7,7,0,0,2,10,0,Matches,New England Revolution
Earl Edwards Jr.,USA,GK,32,1.0,0,0,0,0,0,0,0,,0,0,0,0,0,0,1,1,Matches,New England Revolution
Bobby Wood,USA,FW,31,0.6,0,0,0,0,0,0,0,,0,1,0,1,0,0,0,0,Matches,New England Revolution
Brandon Bye,USA,DF,28,0.6,1,1,0,1,0,0,2,0.0,2,1,0,1,0,1,2,0,Matches,New England Revolution
Jack Panayotou,USA,FW,20,0.3,1,0,0,1,0,1,1,100.0,0,2,0,2,0,1,0,0,Matches,New England Revolution
Thomas McNamara,USA,MF,33,0.1,0,0,0,0,0,0,0,,0,0,0,0,0,0,0,0,Matches,New England Revolution
Emeka Eneli,USA,MF,24,19.3,39,24,13,22,4,17,37,45.9,20,28,4,24,34,73,14,0,Matches,Real Salt Lake
Cristian Arango,COL,FW,29,18.6,15,10,3,8,4,5,16,31.3,11,15,0,15,3,18,3,0,Matches,Real Salt Lake
Braian Ojeda,PAR,MF,24,18.6,29,21,9,16,4,11,26,42.3,15,13,2,11,20,49,24,2,Matches,Real Salt Lake
Carlos Gómez,COL,FW,21,17.4,33,21,10,15,8,11,35,31.4,24,23,4,19,6,39,11,0,Matches,Real Salt Lake
Andrew Brody,USA,DF,29,17.8,13,11,10,3,0,7,18,38.9,11,16,8,8,19,32,40,1,Matches,Real Salt Lake
Zac MacMath,USA,GK,32,16.0,0,0,0,0,0,0,0,,0,0,0,0,1,1,7,5,Matches,Real Salt Lake
Diego Luna,USA,FW,20,14.9,26,16,5,16,5,9,15,60.0,6,13,2,11,7,33,6,0,Matches,Real Salt Lake
Brayan Vera,COL,DF,25,15.0,20,10,11,9,0,7,10,70.0,3,25,18,7,7,27,52,0,Matches,Real Salt Lake
Justen Glad,USA,DF,27,15.0,12,7,7,5,0,6,14,42.9,8,29,20,9,22,34,42,1,Matches,Real Salt Lake
Alexandros Katranis,GRE,DF,26,13.2,26,15,13,11,2,10,26,38.5,16,24,6,18,17,43,18,0,Matches,Real Salt Lake
Matt Crooks, ENG,MF,30,11.9,19,15,4,14,1,10,22,45.5,12,18,0,18,5,24,16,0,Matches,Real Salt Lake
Bode Davis,USA,DF,22,11.1,21,19,14,7,0,13,21,61.9,8,10,4,6,12,33,30,0,Matches,Real Salt Lake
Anderson Julio,ECU,FW,28,8.7,5,4,0,1,4,2,13,15.4,11,9,0,9,5,10,6,0,Matches,Real Salt Lake
Fidel Barajas,MEX,FW,18,6.3,5,3,2,1,2,1,4,25.0,3,2,0,2,1,6,2,0,Matches,Real Salt Lake
Bryan Oviedo,CRC,DF,34,5.7,7,6,5,2,0,3,6,50.0,3,6,3,3,10,17,9,0,Matches,Real Salt Lake
Philip Quinton,USA,DF,24,5.2,12,9,6,6,0,8,12,66.7,4,20,8,12,4,16,27,1,Matches,Real Salt Lake
Gavin Beavers,USA,GK,19,5.0,0,0,0,0,0,0,0,,0,0,0,0,0,0,4,0,Matches,Real Salt Lake
Nelson Palacio,COL,MF,23,3.9,6,3,4,2,0,3,8,37.5,5,4,0,4,6,12,9,0,Matches,Real Salt Lake
Marcelo Silva,URU,DF,35,2.0,2,2,2,0,0,1,3,33.3,2,2,2,0,2,4,16,0,Matches,Real Salt Lake
Pablo Ruíz,ARG,MF,25,1.9,0,0,0,0,0,0,2,0.0,2,2,0,2,1,1,0,0,Matches,Real Salt Lake
Maikel Chang,CUB,MF,33,1.9,5,4,2,3,0,2,3,66.7,1,6,0,6,1,6,3,0,Matches,Real Salt Lake
Noel Caliskan,GER,MF,23,1.4,3,2,0,2,1,2,2,100.0,0,1,0,1,2,5,1,0,Matches,Real Salt Lake
Tommy Silva,USA,DF,22,0.2,0,0,0,0,0,0,0,,0,0,0,0,2,2,3,0,Matches,Real Salt Lake
Zavier Gozo,USA,FW,17,0.1,0,0,0,0,0,0,0,,0,1,0,1,1,1,0,0,Matches,Real Salt Lake
Hugo Lloris,FRA,GK,37,21.0,1,1,1,0,0,1,2,50.0,1,0,0,0,0,1,8,1,Matches,Los Angeles FC
Denis Bouanga,GAB,FW,29,20.9,20,13,5,4,11,7,20,35.0,13,19,0,19,4,24,9,0,Matches,Los Angeles FC
Timmy Tillman,GER,MF,25,20.3,58,42,19,24,15,28,51,54.9,23,21,5,16,22,80,17,0,Matches,Los Angeles FC
Mateusz Bogusz,POL,FW,22,19.6,23,14,9,8,6,8,24,33.3,16,4,0,4,6,29,6,0,Matches,Los Angeles FC
Eduard Atuesta,COL,MF,27,17.8,31,15,18,10,3,17,43,39.5,26,16,3,13,23,54,11,0,Matches,Los Angeles FC
Aaron Long,USA,DF,31,17.5,22,15,15,7,0,12,17,70.6,5,29,22,7,20,42,85,0,Matches,Los Angeles FC
Jesús David Murillo Largacha,COL,DF,30,16.8,31,19,25,6,0,19,31,61.3,12,22,15,7,23,54,69,1,Matches,Los Angeles FC
Sergi Palencia,ESP,DF,28,16.4,53,33,26,23,4,30,37,81.1,7,25,6,19,18,71,26,0,Matches,Los Angeles FC
Ilie Sánchez,ESP,MF,33,16.4,30,20,14,11,5,17,31,54.8,14,23,12,11,29,59,34,0,Matches,Los Angeles FC
Ryan Hollingshead,USA,DF,33,15.6,50,39,32,13,5,31,43,72.1,12,21,5,16,27,77,37,0,Matches,Los Angeles FC
Cristian Olivera,URU,FW,22,15.0,24,18,7,9,8,11,37,29.7,26,15,1,14,4,28,5,0,Matches,Los Angeles FC
Omar Campos,MEX,DF,21,9.7,15,8,12,3,0,12,27,44.4,15,5,0,5,10,25,20,0,Matches,Los Angeles FC
Maxime Chanot,LUX,DF,34,6.7,10,7,7,3,0,5,8,62.5,3,7,5,2,13,23,42,0,Matches,Los Angeles FC
Kei Kamara,SLE,FW,39,6.3,5,4,2,2,1,3,6,50.0,3,3,3,0,0,5,12,0,Matches,Los Angeles FC
Eddie Segura,COL,DF,27,4.5,2,0,1,1,0,1,5,20.0,4,5,2,3,8,10,13,1,Matches,Los Angeles FC
Erik Duenas,USA,MF,19,2.8,12,7,5,6,1,8,15,53.3,7,1,0,1,3,15,2,0,Matches,Los Angeles FC
Nathan Ordaz,SLV,FW,20,1.9,2,1,1,0,1,1,2,50.0,1,2,0,2,0,2,1,0,Matches,Los Angeles FC
David Martínez,VEN,FW,18,1.2,1,1,0,0,1,0,1,0.0,1,1,0,1,0,1,3,0,Matches,Los Angeles FC
Tomas Ángel,COL,FW,21,0.5,1,1,0,0,1,0,2,0.0,2,0,0,0,0,1,0,0,Matches,Los Angeles FC
Luis Müller,GER,FW,23,0.1,0,0,0,0,0,0,0,,0,0,0,0,1,1,1,0,Matches,Los Angeles FC
Michael Boxall,NZL,DF,35,20.5,21,10,13,5,3,13,17,76.5,4,24,14,10,22,43,103,1,Matches,Minnesota United
Wil Trapp,USA,MF,31,17.3,37,21,13,20,4,17,34,50.0,17,15,7,8,19,56,21,0,Matches,Minnesota United
Jeong Sangbin,KOR,FW,22,16.2,11,9,5,3,3,5,16,31.3,11,13,0,13,6,17,8,1,Matches,Minnesota United
Robin Lod,FIN,MF,31,15.3,27,19,7,14,6,12,22,54.5,10,8,1,7,9,36,12,0,Matches,Minnesota United
Joseph Rosales,HON,DF,23,15.9,41,23,24,12,5,21,33,63.6,12,18,4,14,40,81,31,0,Matches,Minnesota United
D.J. Taylor,USA,DF,26,15.5,37,26,23,10,4,24,37,64.9,13,10,1,9,32,69,50,0,Matches,Minnesota United
Dayne St. Clair,CAN,GK,27,15.0,2,1,2,0,0,2,4,50.0,2,1,0,1,0,2,11,1,Matches,Minnesota United
Miguel Tapias,MEX,DF,27,14.1,22,15,14,7,1,16,23,69.6,7,15,8,7,16,38,58,1,Matches,Minnesota United
Devin Padelford,USA,DF,21,13.0,25,17,16,8,1,18,27,66.7,9,11,0,11,24,49,45,0,Matches,Minnesota United
Hassani Dotson,USA,MF,26,12.8,19,12,6,10,3,8,13,61.5,5,14,1,13,12,31,23,0,Matches,Minnesota United
Bongokuhle Hlongwane,RSA,FW,24,11.6,17,8,4,10,3,5,11,45.5,6,18,6,12,5,22,9,0,Matches,Minnesota United
Caden Clark,USA,DF,21,10.0,24,16,11,9,4,11,21,52.4,10,20,3,17,12,36,12,1,Matches,Minnesota United
Teemu Pukki,FIN,FW,34,8.7,4,0,0,2,2,2,8,25.0,6,14,2,12,2,6,2,0,Matches,Minnesota United
Kervin Arriaga,HON,DF,26,9.8,16,14,11,5,0,9,17,52.9,8,14,7,7,9,25,40,0,Matches,Minnesota United
Tani Oluwaseyi,CAN,FW,24,6.9,6,4,2,2,2,1,5,20.0,4,9,3,6,3,9,5,0,Matches,Minnesota United
Franco Fragapane,ARG,MF,31,6.7,9,5,1,6,2,3,7,42.9,4,2,0,2,2,11,2,0,Matches,Minnesota United
Clint Irwin,USA,GK,35,5.0,0,0,0,0,0,0,0,,0,0,0,0,0,0,5,0,Matches,Minnesota United
Alejandro Bran,CRC,MF,23,3.1,3,2,0,3,0,1,3,33.3,2,4,1,3,4,7,2,0,Matches,Minnesota United
Carlos Harvey,PAN,MF,24,2.4,7,5,1,4,2,2,6,33.3,4,1,1,0,2,9,3,0,Matches,Minnesota United
Victor Eriksson,SWE,DF,23,1.8,1,1,1,0,0,0,0,,0,0,0,0,0,1,7,1,Matches,Minnesota United
Jordan Adebayo-Smith,NGA,FW,24,2.7,5,3,5,0,0,0,1,0.0,1,4,0,4,1,6,1,0,Matches,Minnesota United
Moses Nyeman,USA,MF,20,1.5,4,1,2,2,0,1,4,25.0,3,3,0,3,4,8,1,0,Matches,Minnesota United
Hugo Bacharach,ESP,DF,22,1.0,2,1,0,2,0,1,2,50.0,1,0,0,0,3,5,2,0,Matches,Minnesota United
Alec Smir,USA,GK,25,1.0,0,0,0,0,0,0,0,,0,0,0,0,0,0,0,0,Matches,Minnesota United
Morris Duggan,GER,DF,23,0.5,0,0,0,0,0,0,0,,0,1,1,0,1,1,3,0,Matches,Minnesota United
Loïc Mesanvi,TOG,FW,20,0.5,1,1,0,0,1,0,0,,0,2,0,2,0,1,1,0,Matches,Minnesota United
Zarek Valentin,PUR,DF,32,0.4,0,0,0,0,0,0,0,,0,1,0,1,0,0,3,0,Matches,Minnesota United
Patrick Weah,LBR,FW,20,0.4,0,0,0,0,0,0,0,,0,1,1,0,0,0,0,0,Matches,Minnesota United
Emanuel Reynoso,ARG,MF,28,0.3,1,1,1,0,0,0,0,,0,0,0,0,0,1,0,0,Matches,Minnesota United
Kage Romanshyn,USA,FW,19,0.1,0,0,0,0,0,0,0,,0,0,0,0,0,0,0,0,Matches,Minnesota United
Rory O'Driscoll,USA,FW,24,0.0,0,0,0,0,0,0,0,,0,0,0,0,0,0,0,0,Matches,Minnesota United
Maya Yoshida,JPN,DF,35,22.0,15,9,8,6,1,8,16,50.0,8,30,22,8,28,43,93,2,Matches,LA Galaxy
Miki Yamane,JPN,DF,30,20.7,31,22,20,10,1,18,35,51.4,17,21,6,15,19,50,61,2,Matches,LA Galaxy
John McCarthy,USA,GK,32,20.0,0,0,0,0,0,0,0,,0,0,0,0,0,0,10,3,Matches,LA Galaxy
Marky Delgado,USA,MF,29,19.8,48,30,21,18,9,24,47,51.1,23,33,7,26,23,71,24,2,Matches,LA Galaxy
Julián Aude,ARG,DF,21,18.0,48,29,32,14,2,32,60,53.3,28,31,7,24,20,68,61,1,Matches,LA Galaxy
Gabriel Chaves,BRA,FW,23,18.3,29,20,15,11,3,9,24,37.5,15,21,2,19,15,44,5,0,Matches,LA Galaxy
Riqui Puig,ESP,MF,24,17.2,13,10,8,4,1,4,22,18.2,18,11,2,9,9,22,2,1,Matches,LA Galaxy
Dejan Joveljić,SRB,FW,24,15.8,7,6,3,1,3,4,8,50.0,4,7,0,7,1,8,17,0,Matches,LA Galaxy
Joseph Paintsil,GHA,FW,26,15.1,9,5,4,2,3,1,5,20.0,4,12,2,10,5,14,5,0,Matches,LA Galaxy
Edwin Cerrillo,USA,MF,23,15.1,21,14,13,6,2,11,24,45.8,13,20,8,12,9,30,17,1,Matches,LA Galaxy
Diego Fagúndez,URU,FW,29,12.6,13,6,7,3,3,5,14,35.7,9,10,1,9,3,16,7,0,Matches,LA Galaxy
Martín Cáceres,URU,DF,37,9.7,9,5,8,0,1,5,7,71.4,2,9,7,2,7,16,36,0,Matches,LA Galaxy
Gastón Brugman,URU,MF,31,9.5,28,15,15,9,4,17,24,70.8,7,17,9,8,26,54,18,0,Matches,LA Galaxy
Jalen Neal,USA,DF,20,9.4,14,8,7,7,0,7,11,63.6,4,11,9,2,11,25,33,1,Matches,LA Galaxy
Miguel Berry,ESP,FW,26,6.3,7,1,2,2,3,0,2,0.0,2,8,1,7,1,8,6,0,Matches,LA Galaxy
John Nelson,USA,DF,25,3.5,7,5,3,4,0,3,5,60.0,2,2,1,1,3,10,18,1,Matches,LA Galaxy
Novak Mićović,SRB,GK,22,2.0,0,0,0,0,0,0,0,,0,0,0,0,0,0,1,0,Matches,LA Galaxy
Jonathan Perez,MEX,FW,21,1.5,3,3,1,2,0,3,5,60.0,2,1,0,1,0,3,3,0,Matches,LA Galaxy
Eriq Zavaleta,SLV,DF,31,1.8,3,2,3,0,0,2,2,100.0,0,3,3,0,2,5,9,0,Matches,LA Galaxy
Tucker Lepley,USA,MF,22,0.5,0,0,0,0,0,0,1,0.0,1,2,0,2,1,1,1,0,Matches,LA Galaxy
Mauricio Cuevas,USA,FW,21,1.7,5,2,2,2,1,1,1,100.0,0,2,1,1,1,6,5,0,Matches,LA Galaxy
Daniel Aguirre,USA,MF,25,1.2,5,1,3,1,1,2,5,40.0,3,0,0,0,1,6,3,0,Matches,LA Galaxy
Carlos Garcés,COL,DF,22,0.0,0,0,0,0,0,0,0,,0,0,0,0,0,0,0,0,Matches,LA Galaxy
Isaiah Parente,USA,MF,24,0.0,0,0,0,0,0,0,0,,0,0,0,0,0,0,0,0,Matches,LA Galaxy
Rubén Ramos,USA,MF,17,0.0,0,0,0,0,0,0,0,,0,0,0,0,0,0,0,0,Matches,LA Galaxy
Yohei Takaoka,JPN,GK,28,20.0,0,0,0,0,0,0,0,,0,0,0,0,0,0,6,2,Matches,Vancouver Whitecaps
Ryan Gauld, SCO,FW,28,19.5,43,24,11,23,9,17,32,53.1,15,23,0,23,6,49,9,0,Matches,Vancouver Whitecaps
Brian White,USA,FW,28,17.4,8,4,2,3,3,3,10,30.0,7,10,0,10,6,14,31,0,Matches,Vancouver Whitecaps
Ranko Veselinović,SRB,DF,25,16.7,14,10,11,3,0,6,11,54.5,5,21,10,11,8,22,92,1,Matches,Vancouver Whitecaps
Pedro Vite,ECU,MF,22,15.3,29,23,11,14,4,11,27,40.7,16,15,3,12,18,47,12,1,Matches,Vancouver Whitecaps
Tristan Blackmon,USA,DF,27,14.0,6,5,5,1,0,4,5,80.0,1,15,9,6,10,16,61,0,Matches,Vancouver Whitecaps
Andrés Cubas,PAR,MF,28,13.4,49,29,16,28,5,19,37,51.4,18,23,4,19,30,79,9,0,Matches,Vancouver Whitecaps
Mathías Laborda,URU,DF,24,13.3,28,17,23,5,0,20,36,55.6,16,16,7,9,23,51,41,1,Matches,Vancouver Whitecaps
Alessandro Schöpf,AUT,MF,30,11.7,12,9,5,6,1,7,19,36.8,12,11,1,10,8,20,13,0,Matches,Vancouver Whitecaps
Ali Ahmed,CAN,MF,23,10.7,21,13,10,9,2,13,31,41.9,18,11,0,11,19,40,10,0,Matches,Vancouver Whitecaps
Ryan Raposo,CAN,DF,25,10.2,19,9,15,2,2,11,15,73.3,4,8,6,2,16,35,10,0,Matches,Vancouver Whitecaps
Javain Brown,JAM,DF,25,10.0,14,9,8,6,0,10,12,83.3,2,14,8,6,9,23,35,1,Matches,Vancouver Whitecaps
Fafà Picault,HAI,FW,33,9.8,9,5,2,5,2,4,13,30.8,9,12,2,10,8,17,9,0,Matches,Vancouver Whitecaps
Bjørn Inge Utvik,NOR,DF,28,7.8,10,7,6,3,1,6,6,100.0,0,4,2,2,3,13,37,0,Matches,Vancouver Whitecaps
Sebastian Berhalter,USA,MF,23,9.0,24,13,10,9,5,13,28,46.4,15,18,4,14,8,32,15,1,Matches,Vancouver Whitecaps
Luís Martins,POR,DF,32,7.2,8,6,5,2,1,5,9,55.6,4,5,1,4,8,16,9,0,Matches,Vancouver Whitecaps
Damir Kreilach,CRO,FW,35,4.2,1,1,0,1,0,1,3,33.3,2,2,0,2,2,3,6,0,Matches,Vancouver Whitecaps
Levonte Johnson,CAN,FW,25,3.7,5,5,4,1,0,2,3,66.7,1,4,0,4,1,6,1,0,Matches,Vancouver Whitecaps
Sam Adekugbe,CAN,MF,29,2.6,3,1,2,1,0,1,1,100.0,0,1,0,1,2,5,3,0,Matches,Vancouver Whitecaps
Giuseppe Bovalina,AUS,FW,19,1.6,1,1,0,1,0,1,1,100.0,0,0,0,0,0,1,4,0,Matches,Vancouver Whitecaps
Ralph Priso-Mbongue,CAN,MF,21,0.8,2,1,1,1,0,1,3,33.3,2,3,1,2,0,2,2,0,Matches,Vancouver Whitecaps
Jay Herdman,NZL,FW,19,0.1,0,0,0,0,0,0,0,,0,0,0,0,0,0,0,0,Matches,Vancouver Whitecaps
Cyprian Kachwele,TAN,MF,19,0.0,0,0,0,0,0,0,0,,0,0,0,0,0,0,0,0,Matches,Vancouver Whitecaps
Brad Stuver,USA,GK,33,21.0,0,0,0,0,0,0,2,0.0,2,0,0,0,0,0,16,2,Matches,Austin FC
Jáder Obrian,COL,FW,29,15.7,16,7,9,4,3,7,28,25.0,21,24,2,22,10,26,6,0,Matches,Austin FC
Alexander Ring,FIN,MF,33,18.9,33,19,19,9,5,11,44,25.0,33,20,12,8,23,56,34,1,Matches,Austin FC
Jon Gallagher,IRL,DF,28,17.9,29,22,20,7,2,15,28,53.6,13,18,6,12,9,38,37,0,Matches,Austin FC
Diego Rubio,CHI,FW,31,16.1,22,14,8,9,5,13,28,46.4,15,17,1,16,7,29,6,0,Matches,Austin FC
Brendan Hines-Ike,USA,DF,29,16.5,17,10,11,5,1,8,12,66.7,4,26,23,3,6,23,56,1,Matches,Austin FC
Sebastián Driussi,ARG,MF,28,14.5,14,10,6,3,5,4,14,28.6,10,11,1,10,4,18,11,1,Matches,Austin FC
Guilherme Biro,BRA,DF,24,13.9,30,19,14,9,7,15,21,71.4,6,18,5,13,16,46,35,0,Matches,Austin FC
Daniel Pereira,VEN,MF,23,13.6,18,8,6,9,3,8,20,40.0,12,16,4,12,16,34,11,1,Matches,Austin FC
Julio Cascante,CRC,DF,30,12.5,16,12,10,6,0,8,19,42.1,11,15,13,2,16,32,49,0,Matches,Austin FC
Owen Wolff,USA,FW,19,12.4,16,8,7,4,5,11,19,57.9,8,13,3,10,4,20,19,0,Matches,Austin FC
Jhojan Valencia,COL,MF,27,10.1,24,15,9,12,3,8,20,40.0,12,9,4,5,9,33,23,0,Matches,Austin FC
Emiliano Rigoni,ARG,FW,31,7.8,8,4,5,2,1,6,10,60.0,4,10,5,5,4,12,10,0,Matches,Austin FC
Ethan Finlay,USA,FW,33,7.5,12,6,4,4,4,7,14,50.0,7,6,1,5,0,12,7,0,Matches,Austin FC
Leo Väisänen,FIN,DF,26,7.0,11,7,9,2,0,6,8,75.0,2,10,8,2,3,14,32,1,Matches,Austin FC
Matt Hedges,USA,DF,34,6.2,5,2,5,0,0,4,4,100.0,0,10,7,3,8,13,36,0,Matches,Austin FC
Žan Kolmanič,SVN,DF,24,5.6,10,9,7,1,2,3,5,60.0,2,1,1,0,2,12,18,0,Matches,Austin FC
Gyasi Zardes,USA,FW,32,7.1,15,12,7,7,1,6,8,75.0,2,5,2,3,4,19,14,0,Matches,Austin FC
Hector Jiménez,USA,DF,35,4.4,5,3,4,1,0,2,6,33.3,4,2,1,1,5,10,7,0,Matches,Austin FC
CJ Fodrey,USA,FW,20,1.8,2,0,0,1,1,1,4,25.0,3,1,0,1,1,3,0,0,Matches,Austin FC
Alonso Ramírez,MEX,MF,22,0.3,0,0,0,0,0,0,0,,0,0,0,0,1,1,0,0,Matches,Austin FC
Bryant Farkarlun,USA,FW,22,0.1,0,0,0,0,0,0,0,,0,0,0,0,0,0,0,0,Matches,Austin FC
Artur,BRA,MF,28,20.9,42,30,21,19,2,22,41,53.7,19,23,7,16,12,54,34,2,Matches,Houston Dynamo
Aliyu Ibrahim,NGA,FW,22,19.8,25,17,8,8,9,12,26,46.2,14,16,1,15,7,32,13,0,Matches,Houston Dynamo
Griffin Dorsey,USA,DF,25,17.8,26,16,14,10,2,13,24,54.2,11,11,3,8,9,35,37,0,Matches,Houston Dynamo
Micael,BRA,DF,23,18.8,30,20,24,6,0,15,26,57.7,11,26,21,5,22,52,86,1,Matches,Houston Dynamo
Steve Clark,USA,GK,38,17.8,0,0,0,0,0,0,0,,0,0,0,0,0,0,8,1,Matches,Houston Dynamo
Amine Bassi,FRA,MF,26,17.3,10,6,1,5,4,5,14,35.7,9,9,0,9,4,14,3,0,Matches,Houston Dynamo
Sebastian Kowalczyk,POL,FW,25,16.1,12,8,2,4,6,6,13,46.2,7,16,1,15,10,22,6,0,Matches,Houston Dynamo
Adalberto Carrasquilla,PAN,FW,25,15.6,19,10,5,10,4,14,24,58.3,10,13,3,10,10,29,5,1,Matches,Houston Dynamo
Erik Sviatchenko,DEN,DF,32,14.2,15,11,11,3,1,6,9,66.7,3,12,10,2,17,32,47,1,Matches,Houston Dynamo
Héctor Herrera,MEX,MF,34,11.0,15,8,6,7,2,9,21,42.9,12,7,0,7,11,26,10,2,Matches,Houston Dynamo
Franco Escobar,ARG,DF,29,10.7,48,29,27,14,7,34,50,68.0,16,15,1,14,13,61,17,0,Matches,Houston Dynamo
Latif Blessing,GHA,FW,27,8.0,14,11,7,6,1,3,10,30.0,7,6,0,6,7,21,7,1,Matches,Houston Dynamo
Daniel Steres,USA,DF,33,8.7,21,16,14,5,2,12,14,85.7,2,9,2,7,4,25,25,1,Matches,Houston Dynamo
Ethan Bartlow,USA,DF,24,8.4,16,10,13,3,0,11,14,78.6,3,16,10,6,3,19,38,0,Matches,Houston Dynamo
Tate Schmitt,USA,DF,27,4.5,7,6,6,1,0,5,8,62.5,3,5,1,4,5,12,7,1,Matches,Houston Dynamo
Ján Greguš,SVK,MF,33,4.2,4,4,1,3,0,1,4,25.0,3,3,0,3,4,8,1,1,Matches,Houston Dynamo
Sebastián Ferreira,PAR,FW,26,4.3,4,2,0,3,1,1,7,14.3,6,3,0,3,0,4,2,0,Matches,Houston Dynamo
Andrew Tarbell,USA,GK,30,3.2,0,0,0,0,0,0,0,,0,0,0,0,0,0,2,0,Matches,Houston Dynamo
Brooklyn Raines,USA,MF,19,2.8,4,3,3,1,0,0,1,0.0,1,3,0,3,0,4,1,1,Matches,Houston Dynamo
Gabe Segal,USA,FW,23,2.1,2,1,0,2,0,1,3,33.3,2,1,0,1,0,2,2,0,Matches,Houston Dynamo
Brad Smith,AUS,FW,30,3.6,7,3,5,1,1,3,9,33.3,6,3,1,2,0,7,7,0,Matches,Houston Dynamo
McKinze Gaines,USA,MF,26,0.2,0,0,0,0,0,0,0,,0,0,0,0,0,0,0,0,Matches,Houston Dynamo
Jefferson Valverde,ECU,DF,25,0.1,0,0,0,0,0,0,1,0.0,1,0,0,0,0,0,0,0,Matches,Houston Dynamo
Andreas Maxsø,DEN,DF,30,22.0,17,10,13,4,0,9,14,64.3,5,29,22,7,15,32,93,0,Matches,Colorado Rapids
Zack Steffen,USA,GK,29,22.0,1,0,1,0,0,1,2,50.0,1,0,0,0,0,1,12,1,Matches,Colorado Rapids
Cole Bassett,USA,MF,22,21.8,53,30,21,26,6,30,64,46.9,34,29,3,26,18,71,24,2,Matches,Colorado Rapids
Djordje Mihailovic,USA,MF,25,20.4,15,14,2,7,6,10,23,43.5,13,16,2,14,11,26,7,0,Matches,Colorado Rapids
Rafael Navarro,BRA,FW,24,19.2,38,23,10,19,9,9,22,40.9,13,34,3,31,6,44,6,0,Matches,Colorado Rapids
Keegan Rosenberry,USA,DF,30,19.7,20,12,13,5,2,13,21,61.9,8,26,11,15,29,49,48,0,Matches,Colorado Rapids
Sam Vines,USA,DF,25,18.6,22,12,17,3,2,19,28,67.9,9,22,6,16,20,42,37,1,Matches,Colorado Rapids
Oliver Larraz,USA,MF,22,15.5,43,24,15,24,4,21,49,42.9,28,24,4,20,23,66,19,0,Matches,Colorado Rapids
Moïse Bombito,CAN,DF,24,15.2,27,19,18,8,1,15,19,78.9,4,13,9,4,19,46,65,1,Matches,Colorado Rapids
Kevin Cabral,FRA,FW,24,12.1,12,6,5,5,2,5,19,26.3,14,16,2,14,10,22,12,1,Matches,Colorado Rapids
Omir Fernandez,USA,FW,25,12.3,18,11,4,9,5,8,18,44.4,10,12,1,11,7,25,7,0,Matches,Colorado Rapids
Calvin Harris, ENG,FW,24,11.2,15,8,3,8,4,12,27,44.4,15,13,1,12,0,15,4,1,Matches,Colorado Rapids
Connor Ronan,IRL,MF,26,8.6,18,11,8,8,2,10,26,38.5,16,8,0,8,9,27,7,0,Matches,Colorado Rapids
Lalas Abubakar,GHA,DF,29,6.7,4,3,3,1,0,2,2,100.0,0,4,4,0,10,14,33,0,Matches,Colorado Rapids
Darren Yapi,USA,FW,19,5.4,11,6,2,6,3,3,6,50.0,3,4,0,4,2,13,2,0,Matches,Colorado Rapids
Sebastian Anderson,USA,DF,21,3.5,4,3,3,1,0,3,10,30.0,7,5,1,4,6,10,11,0,Matches,Colorado Rapids
Jackson Travis,USA,DF,20,1.7,4,2,2,0,2,1,2,50.0,1,2,0,2,0,4,5,0,Matches,Colorado Rapids
Jasper Löffelsend,GER,MF,26,2.5,13,6,7,6,0,9,13,69.2,4,4,1,3,2,15,4,1,Matches,Colorado Rapids
Jonathan Lewis,USA,FW,27,2.0,4,3,2,1,1,1,2,50.0,1,1,0,1,0,4,1,0,Matches,Colorado Rapids
Kimani Stewart-Baynes,CAN,MF,19,0.7,2,1,0,1,1,2,4,50.0,2,1,0,1,0,2,0,0,Matches,Colorado Rapids
Michael Edwards,USA,DF,23,0.4,2,1,2,0,0,2,2,100.0,0,0,0,0,1,3,0,0,Matches,Colorado Rapids
Lamine Diack,SEN,FW,23,0.2,3,2,3,0,0,1,1,100.0,0,0,0,0,2,5,0,0,Matches,Colorado Rapids
Wayne Frederick,TRI,MF,20,0.0,0,0,0,0,0,0,0,,0,0,0,0,0,0,1,0,Matches,Colorado Rapids
Juan David Mosquera,COL,DF,21,19.5,39,26,26,8,5,19,40,47.5,21,21,3,18,13,52,39,1,Matches,Portland Timbers
Santiago Moreno,COL,FW,24,17.1,37,25,8,15,14,15,29,51.7,14,25,2,23,8,45,6,0,Matches,Portland Timbers
Evander,BRA,MF,26,17.3,23,15,8,8,7,13,27,48.1,14,14,1,13,3,26,6,0,Matches,Portland Timbers
Diego Chará,COL,MF,38,17.1,52,33,24,26,2,23,32,71.9,9,11,2,9,24,76,23,2,Matches,Portland Timbers
Jonathan Rodríguez,URU,FW,30,16.9,9,6,5,4,0,4,8,50.0,4,11,0,11,5,14,16,0,Matches,Portland Timbers
Kamal Miller,CAN,DF,27,15.0,12,8,11,1,0,10,13,76.9,3,18,13,5,13,25,63,1,Matches,Portland Timbers
Antony,BRA,FW,22,14.6,32,24,13,12,7,11,25,44.0,14,17,1,16,13,45,11,0,Matches,Portland Timbers
Dario Župarić,BIH,DF,32,14.3,30,20,23,5,2,15,23,65.2,8,23,12,11,17,47,73,1,Matches,Portland Timbers
Maxime Crépeau,CAN,GK,30,12.5,0,0,0,0,0,0,1,0.0,1,0,0,0,1,1,8,3,Matches,Portland Timbers
Felipe Mora,CHI,FW,30,11.8,3,1,0,1,2,0,2,0.0,2,7,2,5,2,5,8,0,Matches,Portland Timbers
Cristhian Paredes,PAR,MF,26,12.1,21,13,9,8,4,9,30,30.0,21,24,4,20,16,37,21,0,Matches,Portland Timbers
David Ayala,ARG,MF,21,9.3,33,20,17,11,5,14,31,45.2,17,13,1,12,16,49,23,1,Matches,Portland Timbers
Claudio Bravo,ARG,DF,27,9.5,30,20,14,14,2,19,34,55.9,15,22,6,16,13,43,34,0,Matches,Portland Timbers
Zac McGraw,CAN,DF,27,9.1,12,9,6,5,1,8,12,66.7,4,19,13,6,9,21,68,1,Matches,Portland Timbers
James Pantemis,CAN,GK,27,9.5,0,0,0,0,0,0,0,,0,1,0,1,0,0,13,1,Matches,Portland Timbers
Miguel Araujo,PER,DF,29,8.8,18,12,8,10,0,8,13,61.5,5,12,9,3,9,27,45,0,Matches,Portland Timbers
Eric Miller,USA,DF,31,10.0,14,12,2,9,3,5,5,100.0,0,9,3,6,8,22,30,0,Matches,Portland Timbers
Dairon Asprilla,COL,FW,32,7.6,11,2,6,4,1,5,14,35.7,9,5,0,5,5,16,13,0,Matches,Portland Timbers
Eryk Williamson,USA,MF,27,6.8,10,7,2,7,1,2,8,25.0,6,2,1,1,6,16,1,0,Matches,Portland Timbers
Nathan Fogaça,BRA,FW,25,1.9,0,0,0,0,0,0,2,0.0,2,1,0,1,2,2,2,0,Matches,Portland Timbers
Larrys Mabiala,COD,DF,36,0.5,0,0,0,0,0,0,0,,0,2,1,1,0,0,1,1,Matches,Portland Timbers
Sawyer Jura,USA,DF,18,0.0,1,0,0,1,0,1,1,100.0,0,0,0,0,0,1,0,0,Matches,Portland Timbers
Cristian Roldan,USA,MF,29,20.1,46,30,18,22,6,27,40,67.5,13,25,3,22,17,63,25,0,Matches,Seattle Sounders
Jackson Ragen,USA,DF,25,19.2,14,10,11,3,0,7,12,58.3,5,20,10,10,20,34,73,3,Matches,Seattle Sounders
Jordan Morris,USA,FW,29,18.7,19,11,6,7,6,10,13,76.9,3,10,2,8,5,24,12,0,Matches,Seattle Sounders
Obed Vargas,USA,MF,18,17.8,46,26,15,22,9,16,32,50.0,16,30,12,18,15,61,23,1,Matches,Seattle Sounders
Stefan Frei,SUI,GK,38,16.3,0,0,0,0,0,0,0,,0,0,0,0,0,0,3,2,Matches,Seattle Sounders
Albert Rusnák,SVK,MF,29,16.1,9,8,1,5,3,4,10,40.0,6,8,0,8,12,21,5,0,Matches,Seattle Sounders
Yeimar Gómez Andrade,COL,DF,32,15.6,29,20,21,8,0,15,20,75.0,5,21,11,10,28,57,70,1,Matches,Seattle Sounders
Alex Roldan,SLV,DF,27,13.9,28,22,15,12,1,14,23,60.9,9,17,7,10,10,38,29,0,Matches,Seattle Sounders
Nouhou Tolo,CMR,DF,27,14.4,19,12,14,5,0,12,23,52.2,11,17,8,9,16,35,47,0,Matches,Seattle Sounders
Raúl Ruidíaz,PER,FW,33,13.5,6,3,1,3,2,1,4,25.0,3,9,2,7,1,7,5,0,Matches,Seattle Sounders
João Paulo Mior,BRA,MF,33,10.8,18,11,9,6,3,7,19,36.8,12,15,4,11,26,44,13,0,Matches,Seattle Sounders
Joshua Atencio,USA,MF,22,9.3,29,14,11,11,7,15,33,45.5,18,24,2,22,19,48,10,0,Matches,Seattle Sounders
Léo Chú,BRA,FW,24,5.9,12,5,4,5,3,2,5,40.0,3,7,0,7,3,15,1,0,Matches,Seattle Sounders
Cody Baker,USA,DF,20,5.3,16,14,9,5,2,10,12,83.3,2,4,1,3,4,20,14,0,Matches,Seattle Sounders
Andrew Thomas,RUS,GK,25,4.7,0,0,0,0,0,0,1,0.0,1,0,0,0,0,0,3,0,Matches,Seattle Sounders
Jon Bell,JAM,DF,26,3.9,6,3,3,2,1,3,4,75.0,1,7,5,2,2,8,22,0,Matches,Seattle Sounders
Daniel Musovski,USA,FW,28,4.8,10,7,4,6,0,3,6,50.0,3,4,1,3,1,11,4,0,Matches,Seattle Sounders
Reed Baker-Whiting,USA,DF,19,3.9,12,5,8,3,1,9,12,75.0,3,13,1,12,6,18,12,1,Matches,Seattle Sounders
Xavier Arreaga,ECU,DF,29,2.8,4,3,2,2,0,2,5,40.0,3,5,3,2,6,10,7,1,Matches,Seattle Sounders
Danny Leyva,USA,MF,21,2.0,3,2,2,1,0,0,2,0.0,2,5,0,5,5,8,6,0,Matches,Seattle Sounders
Sota Kitahara,USA,DF,21,1.6,3,1,2,0,1,2,3,66.7,1,0,0,0,1,4,3,0,Matches,Seattle Sounders
Paul Rothrock,USA,FW,25,4.0,4,3,2,2,0,3,5,60.0,2,8,0,8,4,8,1,0,Matches,Seattle Sounders
Pedro De la Vega,ARG,MF,23,1.3,2,1,0,2,0,1,2,50.0,1,2,1,1,0,2,1,0,Matches,Seattle Sounders
Georgi Minoungou,CIV,FW,21,1.1,2,1,1,0,1,1,2,50.0,1,1,0,1,0,2,0,0,Matches,Seattle Sounders
Dylan Teves,USA,MF,24,0.9,2,1,0,2,0,1,2,50.0,1,1,0,1,0,2,1,0,Matches,Seattle Sounders
Nathan Cardoso,BRA,DF,29,0.8,2,2,2,0,0,1,1,100.0,0,4,3,1,0,2,9,0,Matches,Seattle Sounders
Kalani Rienzi,USA,DF,22,0.1,2,0,2,0,0,2,3,66.7,1,0,0,0,0,2,1,0,Matches,Seattle Sounders
Antino Lopez,USA,MF,22,0.1,0,0,0,0,0,0,0,,0,0,0,0,0,0,0,0,Matches,Seattle Sounders
Roman Bürki,SUI,GK,33,20.0,0,0,0,0,0,0,0,,0,0,0,0,0,0,6,2,Matches,St Louis City
Tomas Totland,NOR,DF,25,19.3,36,17,18,14,4,25,38,65.8,13,25,9,16,33,69,44,1,Matches,St Louis City
Chris Durkin,USA,MF,24,18.4,49,33,18,21,10,28,44,63.6,16,27,2,25,26,75,24,1,Matches,St Louis City
Indiana Vassilev,USA,MF,23,16.0,16,12,4,9,3,8,28,28.6,20,23,0,23,5,21,7,0,Matches,St Louis City
Klauss,BRA,FW,27,15.9,13,7,2,6,5,7,14,50.0,7,10,1,9,3,16,14,0,Matches,St Louis City
Tim Parker,USA,DF,31,15.9,16,12,9,5,2,9,12,75.0,3,14,10,4,15,31,43,0,Matches,St Louis City
Anthony Markanich,PHI,DF,24,14.1,35,18,17,14,4,16,32,50.0,16,27,5,22,26,61,51,1,Matches,St Louis City
Célio Pompeu,BRA,FW,24,13.8,26,16,7,11,8,15,30,50.0,15,20,1,19,8,34,8,0,Matches,St Louis City
Joakim Nilsson,SWE,DF,30,9.7,25,15,16,8,1,16,31,51.6,15,9,4,5,15,40,49,1,Matches,St Louis City
Eduard Löwen,GER,MF,27,10.1,19,12,6,13,0,12,26,46.2,14,11,1,10,5,24,4,1,Matches,St Louis City
Aziel Jackson,USA,FW,22,8.9,15,9,5,7,3,5,13,38.5,8,8,0,8,6,21,4,0,Matches,St Louis City
Tomáš Ostrák,CZE,MF,24,7.7,13,6,3,5,5,5,17,29.4,12,11,1,10,10,23,7,0,Matches,St Louis City
Njabulo Blom,RSA,MF,24,7.3,16,12,6,8,2,8,12,66.7,4,7,1,6,11,27,1,0,Matches,St Louis City
Rasmus Alm,SWE,FW,28,6.0,11,6,3,5,3,6,14,42.9,8,8,0,8,4,15,4,0,Matches,St Louis City
Kyle Hiebert,CAN,DF,26,7.2,11,8,6,4,1,9,15,60.0,6,10,6,4,4,15,16,0,Matches,St Louis City
Hosei Kijima,JPN,MF,22,6.7,16,10,4,9,3,4,10,40.0,6,14,0,14,9,25,4,0,Matches,St Louis City
Joshua Yaro,GHA,DF,29,6.4,7,7,5,2,0,5,5,100.0,0,13,10,3,13,20,26,1,Matches,St Louis City
Samuel Adeniran,USA,FW,25,6.0,3,1,2,0,1,0,0,,0,3,1,2,2,5,6,0,Matches,St Louis City
Nökkvi Þórisson,ISL,FW,24,6.0,8,5,4,1,3,2,6,33.3,4,6,0,6,2,10,5,0,Matches,St Louis City
Akil Watts,USA,DF,24,4.6,19,14,9,6,4,14,18,77.8,4,12,4,8,4,23,7,0,Matches,St Louis City
John Klein,USA,FW,24,2.5,5,3,1,3,1,0,4,0.0,4,2,0,2,1,6,3,0,Matches,St Louis City
Jake Nerwinski,USA,DF,29,2.4,4,2,1,3,0,2,4,50.0,2,4,3,1,6,10,12,1,Matches,St Louis City
Jayden Reid,USA,DF,22,2.0,1,0,1,0,0,1,1,100.0,0,6,1,5,2,3,5,0,Matches,St Louis City
Nikolas Dyhr,DEN,DF,23,1.5,2,1,1,1,0,2,4,50.0,2,1,0,1,0,2,5,0,Matches,St Louis City
Michael Wentzel,GER,DF,22,1.1,2,1,1,1,0,1,2,50.0,1,1,0,1,0,2,6,0,Matches,St Louis City
Benjamin Lundt,GER,GK,28,1.0,0,0,0,0,0,0,0,,0,0,0,0,0,0,0,0,Matches,St Louis City
Caden Glover,USA,FW,17,0.3,0,0,0,0,0,0,0,,0,0,0,0,0,0,1,0,Matches,St Louis City
Brendan McSorley,USA,FW,22,0.1,0,0,0,0,0,0,0,,0,0,0,0,0,0,0,0,Matches,St Louis City
Cristian Espinoza,ARG,FW,29,20.3,21,9,7,5,9,10,35,28.6,25,23,0,23,11,32,23,0,Matches,San Jose Earthquakes
Rodrigues,BRA,DF,26,18.6,34,20,31,2,1,23,45,51.1,22,17,10,7,25,59,75,1,Matches,San Jose Earthquakes
Jackson Yueill,USA,MF,27,18.2,35,19,7,25,3,19,33,57.6,14,9,1,8,16,51,25,1,Matches,San Jose Earthquakes
Jeremy Ebobisse,USA,FW,27,14.5,8,5,2,2,4,2,3,66.7,1,6,1,5,4,12,11,0,Matches,San Jose Earthquakes
Vitor Costa,BRA,DF,30,16.1,60,33,34,24,2,33,53,62.3,20,23,5,18,18,78,66,1,Matches,San Jose Earthquakes
William Yarbrough,USA,GK,35,15.0,0,0,0,0,0,0,0,,0,0,0,0,0,0,7,1,Matches,San Jose Earthquakes
Amahl Pellegrino,NOR,FW,34,12.4,10,5,3,6,1,5,13,38.5,8,10,1,9,11,21,8,0,Matches,San Jose Earthquakes
Niko Tsakiris,USA,MF,19,11.5,22,14,12,7,3,11,21,52.4,10,15,4,11,8,30,14,0,Matches,San Jose Earthquakes
Carlos Akapo,EQG,DF,31,12.0,33,20,18,9,6,16,31,51.6,15,13,3,10,25,58,47,0,Matches,San Jose Earthquakes
Carlos Gruezo,ECU,MF,29,11.2,24,9,10,13,1,10,20,50.0,10,10,0,10,14,38,22,1,Matches,San Jose Earthquakes
Paul Marie,FRA,DF,29,11.1,34,25,21,7,6,27,52,51.9,25,19,5,14,15,49,45,0,Matches,San Jose Earthquakes
Tanner Beason,USA,DF,27,10.7,10,4,8,2,0,7,9,77.8,2,21,17,4,10,20,65,0,Matches,San Jose Earthquakes
Bruno Wilson,POR,DF,27,9.6,6,3,5,1,0,2,5,40.0,3,14,13,1,17,23,51,0,Matches,San Jose Earthquakes
Hernán López Muñoz,ARG,MF,23,9.3,25,15,9,9,7,6,23,26.1,17,10,0,10,7,32,4,0,Matches,San Jose Earthquakes
Benjamin Kikanovic,USA,FW,24,7.9,13,6,8,5,0,7,18,38.9,11,11,2,9,2,15,7,0,Matches,San Jose Earthquakes
Preston Judd,USA,FW,25,6.6,4,2,2,1,1,0,2,0.0,2,10,1,9,1,5,2,0,Matches,San Jose Earthquakes
Jack Skahan,USA,MF,26,6.5,4,3,2,2,0,2,8,25.0,6,6,0,6,0,4,0,0,Matches,San Jose Earthquakes
Daniel Munie,USA,DF,24,5.9,8,6,7,1,0,5,11,45.5,6,14,7,7,9,17,18,0,Matches,San Jose Earthquakes
Alfredo Morales,USA,MF,34,5.2,10,5,6,4,0,4,5,80.0,1,4,1,3,4,14,6,0,Matches,San Jose Earthquakes
Daniel,BRA,GK,30,4.0,0,0,0,0,0,0,1,0.0,1,0,0,0,0,0,3,0,Matches,San Jose Earthquakes
Jacob Jackson,USA,GK,24,2.0,0,0,0,0,0,0,0,,0,0,0,0,0,0,1,1,Matches,San Jose Earthquakes
Ousseni Bouda,BFA,FW,24,0.8,1,0,0,1,0,1,1,100.0,0,1,0,1,1,2,1,0,Matches,San Jose Earthquakes
Jamar Ricketts,USA,MF,22,0.4,2,2,1,1,0,1,3,33.3,2,0,0,0,0,2,2,0,Matches,San Jose Earthquakes
Tommy Thompson,USA,DF,28,0.2,1,0,0,1,0,1,2,50.0,1,0,0,0,0,1,0,0,Matches,San Jose Earthquakes
Michael Baldisimo,PHI,MF,24,0.1,3,0,1,2,0,2,3,66.7,1,0,0,0,2,5,1,0,Matches,San Jose Earthquakes
Nemanja Radoja,SRB,MF,31,20.1,37,21,13,23,1,18,32,56.3,14,22,3,19,17,54,22,1,Matches,Sporting Kansas City
Tim Melia,USA,GK,38,19.0,0,0,0,0,0,0,0,,0,0,0,0,1,1,7,2,Matches,Sporting Kansas City
Jake Davis,USA,DF,22,18.7,52,27,19,27,6,23,51,45.1,28,26,5,21,21,73,33,0,Matches,Sporting Kansas City
Erik Thommy,GER,MF,29,17.7,23,16,4,13,6,12,27,44.4,15,26,3,23,9,32,9,1,Matches,Sporting Kansas City
Daniel Rosero,COL,DF,30,16.8,21,15,13,8,0,8,14,57.1,6,19,11,8,19,40,77,1,Matches,Sporting Kansas City
Tim Leibold,GER,DF,30,15.5,40,26,24,11,5,25,44,56.8,19,17,2,15,20,60,21,1,Matches,Sporting Kansas City
Dániel Sallói,HUN,FW,27,15.4,14,6,5,8,1,7,10,70.0,3,17,0,17,8,22,9,0,Matches,Sporting Kansas City
Alan Pulido,MEX,FW,33,14.7,12,3,0,8,4,2,9,22.2,7,3,0,3,3,15,3,0,Matches,Sporting Kansas City
Johnny Russell, SCO,FW,34,13.6,26,17,15,6,5,13,24,54.2,11,23,1,22,6,32,9,0,Matches,Sporting Kansas City
Andreu Fontàs,ESP,DF,34,13.2,18,10,10,7,1,10,29,34.5,19,20,6,14,22,40,40,0,Matches,Sporting Kansas City
Memo Rodriguez,USA,MF,28,11.8,30,15,13,15,2,15,35,42.9,20,7,1,6,19,49,6,0,Matches,Sporting Kansas City
William Agada,NGA,FW,24,11.0,5,2,1,2,2,0,2,0.0,2,2,0,2,2,7,2,0,Matches,Sporting Kansas City
Robert Voloder,BIH,DF,23,9.6,17,8,11,4,2,6,14,42.9,8,12,5,7,15,32,31,2,Matches,Sporting Kansas City
Rémi Walter,FRA,MF,29,8.0,9,4,3,5,1,5,8,62.5,3,2,1,1,7,16,10,0,Matches,Sporting Kansas City
Zorhan Bassong,CAN,DF,25,6.5,21,16,15,5,1,9,11,81.8,2,8,3,5,6,27,13,0,Matches,Sporting Kansas City
Robert Castellanos,USA,DF,26,5.5,3,2,3,0,0,1,2,50.0,1,3,3,0,7,10,26,0,Matches,Sporting Kansas City
Kayden Pierre,USA,DF,21,3.8,7,5,3,2,2,4,6,66.7,2,4,2,2,4,11,12,0,Matches,Sporting Kansas City
Marinos Tzionis,CYP,FW,22,3.1,6,3,0,2,4,0,1,0.0,1,6,1,5,3,9,2,0,Matches,Sporting Kansas City
Alenis Vargas,HON,FW,20,3.7,3,2,0,1,2,2,6,33.3,4,1,0,1,2,5,1,0,Matches,Sporting Kansas City
Stephen Afrifa,CAN,FW,23,3.3,9,4,8,0,1,4,5,80.0,1,6,0,6,1,10,4,0,Matches,Sporting Kansas City
John Pulskamp,USA,GK,23,3.0,0,0,0,0,0,0,0,,0,0,0,0,0,0,1,0,Matches,Sporting Kansas City
Felipe Hernandez,USA,MF,26,4.2,4,1,2,2,0,1,5,20.0,4,10,1,9,2,6,1,0,Matches,Sporting Kansas City
Khiry Shelton,USA,DF,31,3.8,9,4,7,2,0,2,3,66.7,1,5,0,5,2,11,5,1,Matches,Sporting Kansas City
Maarten Paes,NED,GK,26,21.0,0,0,0,0,0,0,0,,0,0,0,0,0,0,10,5,Matches,FC Dallas
Sebastien Ibeagha,USA,DF,32,19.0,20,16,14,5,1,12,16,75.0,4,15,11,4,16,36,82,2,Matches,FC Dallas
Petar Musa,CRO,FW,26,18.8,9,3,3,4,2,2,10,20.0,8,17,2,15,7,16,23,1,Matches,FC Dallas
Sam Junqua,USA,DF,27,17.2,26,20,17,5,4,18,24,75.0,6,18,9,9,19,45,44,0,Matches,FC Dallas
Paul Arriola,USA,DF,29,17.1,27,18,14,10,3,16,35,45.7,19,20,2,18,5,32,19,0,Matches,FC Dallas
Liam Fraser,CAN,MF,26,15.3,19,11,8,9,2,14,21,66.7,7,20,11,9,13,32,20,1,Matches,FC Dallas
Nkosi Tafari,USA,DF,27,16.3,23,19,14,6,3,10,15,66.7,5,19,16,3,14,37,67,1,Matches,FC Dallas
Asier Illarramendi,ESP,MF,34,12.5,38,24,13,19,6,24,47,51.1,23,25,5,20,18,56,23,0,Matches,FC Dallas
Patrickson Delgado,ECU,MF,20,11.0,20,15,7,8,5,8,17,47.1,9,16,2,14,18,38,11,0,Matches,FC Dallas
Marco Farfan,USA,DF,25,11.0,25,14,11,11,3,12,16,75.0,4,9,4,5,11,36,17,0,Matches,FC Dallas
Sebastian Lletget,USA,MF,31,10.4,17,11,7,9,1,7,13,53.8,6,7,1,6,10,27,12,0,Matches,FC Dallas
Ema Twumasi,GHA,DF,27,9.3,13,10,7,4,2,7,14,50.0,7,6,4,2,3,16,21,1,Matches,FC Dallas
Jesús Ferreira,USA,MF,23,9.0,9,6,6,3,0,4,11,36.4,7,5,0,5,5,14,2,0,Matches,FC Dallas
Dante Sealy,USA,DF,21,8.8,14,8,5,5,4,8,12,66.7,4,5,1,4,11,25,15,0,Matches,FC Dallas
Bernard Kamungo,USA,MF,22,8.3,11,9,4,3,4,5,14,35.7,9,10,1,9,5,16,9,0,Matches,FC Dallas
Omar Gonzalez,USA,DF,35,6.9,4,2,3,1,0,1,2,50.0,1,12,9,3,3,7,36,1,Matches,FC Dallas
Eugene Ansah,GHA,FW,29,4.2,5,5,2,3,0,1,1,100.0,0,1,0,1,2,7,4,0,Matches,FC Dallas
Tsiki Ntsabeleng,RSA,MF,26,5.0,7,2,2,4,1,3,7,42.9,4,3,0,3,3,10,3,0,Matches,FC Dallas
Logan Farrington,USA,FW,22,5.5,6,4,2,3,1,0,6,0.0,6,7,1,6,2,8,4,0,Matches,FC Dallas
Nolan Norris,USA,MF,19,1.5,1,0,0,1,0,1,1,100.0,0,2,1,1,2,3,4,0,Matches,FC Dallas
Herbert Endeley,USA,MF,22,1.3,1,1,1,0,0,1,1,100.0,0,1,0,1,1,2,3,0,Matches,FC Dallas
Tomas Pondeca,USA,MF,22,0.8,2,1,0,1,1,0,3,0.0,3,0,0,0,0,2,0,0,Matches,FC Dallas
Tarik Scott,USA,FW,19,0.4,0,0,0,0,0,0,0,,0,2,0,2,0,0,0,0,Matches,FC Dallas
Carle-Fred Sainte,HAI,MF,21,0.3,1,1,0,0,1,0,1,0.0,1,3,0,3,2,3,0,0,Matches,FC Dallas
Paxton Pomykal,USA,MF,24,0.1,1,0,1,0,0,0,0,,0,0,0,0,0,1,0,0,Matches,FC Dallas
